--MoE--XT?M-X-TE--|oo--TX|-TToBEoT--BXoTXo-X?|oTE|-M--T-ETMT?B-M--T-B--X?EoM-?X-?-BE-TTT-ETET--ToX-T|X-XTT----o?oTE-ToT---MTXo-T-?--?TB--Eo-XTT-?TooT--o|T--EooT-E---?----X-??-XTXTET|--MTBM-T?--TT-TTE-
-oXT-TMT-TT||-o?-X-??-B-?oTM-XoMoX-o--B|XoXMTMoE-o-o-|o-oTTET?--oXXTo-ToB----?XB--XMoBo-BX---o?EXT?oB-T?-T|-?BToB-M-o-E-?-?|TTE--?TTT-EoBT-|ToTMBo-??ToTMBETTTE--X-??TTXBTXB?BTT?o?X--?-T--?BETTo-MoT?--
-E----oXEB--BooXTT-T-X--Mo-TBTE-EX-Mo-XBXTToTTEME-M--T|BMXB--?--T-BM--?-X-TE-o--?B---o-oT-E--BTM?|E-XBET-MEXTXTT?oMME-B--T-o?o--B|XB-M-T-T?o-T-XM-oMB-o-T-T?TTX-TXTToMMTMT--E-TTo?-EB-M-B-TBT|XX-|XTT?T-
--T-M-X?Bo---B--XE?Xo-M--BoT------TBXTXEX?T-||-T--MBoMX-X-XXB--BTT|?Eo-XBB-T-o-oB-M-TTXM-o--BEM|EM-X--oT-|T-XT---EXE-XToX-oTT--E-X?B?|?-TT-TXooMT-To-?oTTTTTXTMo-o--T?oB|X-B---EEB---MX--TB--ME|?----XX-
-TT--?X-EoT--B?o--B-oMT-o|BT-|-Eo-Eo----|-TE?X-TBo-B--o--o-BT?-T?BT-BM-TX---MMTBT--o--MXTo?TTT-TTX-|oTMo-M--M-BTXE-o?-E-XBX---MXToEo-TT---?T-XTM---?B?TX-??-EoTT---TTBMooMM--MT|T?XEMBME-?T---XE--T--oE-
-T-TTE?-MB-X---XT-TMBX--EX--TT-T-T-E-?TMo-M?--oB-X-T-TTTX--T|XMEBT??o-M--o-oT-B-TMB-TTT--M---TM-XB-XBoM-oTB?E-TMo---?-?--To--o---Xo---?ME--T-EXo?|ooM-??|-o---Xoo|BM----oMET?-|-XM---|--oT-|--?XE-T--?o-
-TMoo----E-B|??|XTo--BB?o--T-ooBTTETTTooTXTMXB-TM-XT?TXM-XMEMoo|-MoTB--T-X-----?oT-BT-B?TX?MBEToM?X--o?-BT--T-E?BT--B-|T--oo-BoBXTT-|TM-?oT-E-|M-BE-o|--TX-X|E-X--TBTT-oXX-M-E-TXM--XT--o-BTBTE-TT|---M-
-X-X--M--BoE-o-oX-?TB--XEE----TE--X-?oTTX-T?oXX-oo---Mo--Bo-BT-MXT---|-X-X-TooX--B-T|-ETEToE?E?-oooT|?EB-TTTToo--B-oEMTBT-ET-oXBoo-E-E?--TTXoo-?-M-BTT---?-B-BXMo-XoBXoT--B-BoT?oXTo---XXBXB-o-?B---oETv
-XXB-TM--|X-XoTo-XE?TB----?T-oX-?-T|EMBM---?-BTX-X--T--|-TXT?TTE-ooMB--EBXX--TXT-?T---T-o-E-TTXXB-TM-Eo?XM-M-|M----|-|XT-T-ToB-----TM-?B-o-X-oXo|TBT-|B-E?oBooB-TTEMXTT----ToTEET--o--XB-|-X-?TX-BT|MT-f
----T-T-??E|TMTBTToXBoEoB|-?-B---T--?B-BT-XTETo-XEo--B|EE-TTT|XETXoX-|T-B|-o-|-oX-T-o--T-TXMX--XT-|E-XT?---Eo?X?|MTM-T-TMT?T?o-XB-Xo-o--?-XT--To-oX-ETX---o---X--?-B-M?o-----?M-EB-BXB-oEoo--XBE?TX---Xf
-B--EX?-XoXE---B|ooo--T?M--M---T|---|TXTMM--oBoTX-E-?XXTB-MX-BE-X?E|TTTB-o?-oX-XM--TBXXXEETXToXo-|T-XME-----T-Mo-BToXTTB--oT--T-T||---oB-T--T--BE|To----To?XT-B-E?-?EMT-----XM--?----M--oT|-T--oo?|B?TXf
-B-oTBB-----XX-o-T-o-XT?o?-oB--M-E?M?--XToT----TT-M---ToBTBo--X?MTE-oTB--X--MT----oMoE|E---B-TXTT?T-----XBM?-T-|TT-MT-TB-B--EoM|T-oBXX-oBT-Mo-XT---??B-B?B?B?ooB-|-Xo----|E-TTBXoE-o?X--XTX?-TT-To|oBTTf
-oXBX-o---?--Xo-X-TX-BoB-B??oM?MB?M?|-Mo-------BXB-oEB?-o---BX-M|BTX-MX?--oTMTX?-?-E?X?-BX----BBXo---?Xo--XBo-B--o?BMX-XBoo?B-B-BX-o--?MM-M-oMTB-XBX-----X-M----TBB--XE-?-Xo-EM-B-E--BMBE-oX-B?EB?o-?X?f
-?--BBX-MMX-o--o?o----XXoM|M-oooE-XoT---?BB?B-o-o?-BX?ooXX|--XooXXBM--?-X-XXXE-X-o-oBXo--BTET-B-MM-XM|X?Xo-BBB--M?M---?-M-Bo-?-XoB-?|X?BM-XXE-Bo?--B?X?BE-?BX-oT-X-oB-o?--B-EEo?o--BE-oo?-BM?XX?-?-T-B-f
moB-ETM-B?M?-o-|--B?B--?-o-X-XTM?EBXB------BoBo-XBMXMX--XM?-?E?--oE---X?-XX?-E-o--X?EX-XXM-E?BMXo--M??B?TTBMBX?E-o|o-o?|-?-XoMEEXX-X|-oB---?o?o--XXMX?B-MM-BM-X-o-B?B?--XMXo---X-M-X?EMBB-?X?-|M-E--?X-X
X-X-XXXXX-XXXX-X-XXX-X--XXXXXX--XX----X-XXXX-X-X-X-XX-X-XX-XXXXX-XXXXXXXXXXX-X-XXXX-XXXX-XXXXX-XXXXXXX--X--XXXXXX-XX-X-XXXXXXX-X-XXXXXXX-X--XXXXXX-XXX-XXXXXXXX----XXX-XXXXX-XXXXXXXXXXXXX-XXXXXX-X--XXX
