----oT--|X--TTT|?-BTT-||T-T-B---oT--B|o?M-oBXE-?EX?XXBMo-B-oT-TTT-BX-o-TTTo-X-XMT-ooT-XXoB---MT?M-BTXT?|oEBTT--XT-XTTB-o--?Xoo-oXT--EMBToooT-?To-TBT?-TB|TTX-oTTT-o|-X|T-X--E-o----TX-MM-BBEToT?-T?BoTT-
-EB|--X?-o-|XoXB--o---BT-oo--TooX|--T-BT|-M-ME-XTET|-T--M-XB-oM-o|oTTXMTTT?To|E|-Xo?BBo?-?T--MTETXoTToT-o--MBToTT-o--?ETTE--X?B-X?T-T-TTXTEo-B-TXoX?-MT|?ToT??T-XBET--oooXT-MoXM-?MoXoT-|-BX-?T-TTB-T?M-
-ToB|oX-TX|M-T-?-TXT-o?o?--TX?--oXTo-X-?-BX--TBTEMXB--ETBX-TMM-EMBo?T---MBoo-?EETXTTEM|EX?TB-T?-To-X-TETX-T-TT-XB---XTT?-|TTTo-ToEBXoET-T--o-To--X?M--BBTEE-EXX-|-BooT-EoEoXXEM--M?-T||TTTo-M|E--E----?-
--?MTTM-o-|XETE-BT--T--TTX-BoT-X-BMXTo?T-?-o----XE|---X-BoX-X-T?o-M---T-To|-?oTE?XoM---TM-?-XX--?|oXXBXT-|TT-E-?TETT--?XXo?TT-o-TE?XTXoBT--XT-oT?TT-o-TMEo|EoBX|X?T-TTo?oBoXT?-o-B|M-X?Bo-Mo-?T----E?-|-
-o-M|B-X-E-oXoXTB--?ToM-ET?T--BT-?X--MTT-?Eo-B--E-o-TTX-?|--T-T-MM-oT-MTTToT|E-|TT-Xo--XT-|---T--B-TT-X-?o--oT-ooX----?T?BX--|--?oT-ToB-MTT-MX-E|-?TT--TXX?-TEBT-Eo-M--T----o-M-|E--XoM-|oT---T--XT--oT-
---XoEX-?MX--T---BXo-BTTTM--ToTEXE|TM|TBoBT--|?ETT---XB-T-MTXT?oM--|--?TX?o-TBT-|MTMoX-TXo--T?-T--XXoX?BXoX-E--EoEo-XT--X?--?T-T?--E-oX-E?BTMXM-oX-?B-?-MMoXX-?-oTo-Bo-EoMM-M-T-M--T-?|-ME-XXToT?MT--?o-
-T--o-o-oT--?--X?X?--?--T-M-T-oB-BX-XTXBX---ToTXBX-TE?-o|----E-?M?oX-T--X--oX-oMMTX--X-T-X-XM?T-BT---oXEE-T--X-T-T--E--X-E?-?oBB?oMTTX-TTMETEE--oTXT----T---?-TE---ToBE|oX-XM---TMXX---TXo--T--TBEEXX---
-?EX--o-||?T-----XX--o--T-MT-o-TXM-T--X-XM-?|E--XT-TBE?B-T?B|-T?T--oMT-TM---T?-E---oET--TBE--T?--TBM-o-?---TTE---XMX-XTo-Eo-T---X--TX-E-E|BBoXBT?TTooXMXXX-XB--M--E-Xo?X--T-??TM-?-??BT-B---oMX-XXTo--Xv
--ET?-BX|MXTB?-XTT-?-T-B--XT-T-E-o?M-TM-Too?T---EM---BTT--o-XEMXB-?-|-XX--EXoT|T-TT-ET---X--o-oTXo|TEBT-TBTMo-XT-X-T-M-oo?EEBT-EBET-|MXT-XX-M--T??T--|T?---|-oTo--?X?T|T-ToTEM-B--XBT-BEMo?-T-B-?--TB-?f
-XX----E--TB-MToM-M-B-X-oo-EToB?-TTM-TTo--TXXE-B-ETEXo-Bo-To-XTE-|o-TT--oET-TBE?B--TM-Xo?----Mo?X---TET-X--ETXoT-T|M?-TToMTB---X?--B--ooXEE-X--|-o--Moo?XoM--?-?--BX?M-o--MT-|X-T-o|-TE--o-BTTM-T?B-|-Xf
-MBoBo-??EToTB-X-T-TToTT?MMEo-XB-E-TXET--X-TT?--M-oTT-oTT-Eo?X?T-?|-T?-B--oB|-o-oo?TX-MT-B-?ToMT-?-T-T-?MoTXBB-?-EoT-T--T-oM-MTT-ETX--TTB--To--EB?-|--BTXEoTo---?oo-E-M-o-X-XT-XT|EXoTM-TTo--o--o-|MT-Mf
--?-ETToT-T-?--To-Xo|-XE-TTBTEToTXo|MoX--?To-E-?-Xo-XBMMB------T--X---oooTT-o-B-?Bo-E?MX-XT?-E--|o-TXo-E--oXT-XBB----B-TE-EX--M-T-oBMT-BB|-|-EX-BToTX-E-???BoM?--o---E---MTETTBM-ETTToTEX-?XE--X?Xoo-T-f
-XB?Bo--?B-X---EEXB-?X?---?o-oo-MBB-M?-o-B--?oEEXM--T--E--------X-M?T|BE--MEM-o??B?MXTXBXB-X---XBoBB-BoBX-oBB?MX-oTo-B-?M-TXM-XBoB?E--X-B?-X?oo-??---BTX---XM?B--X-?-oo--M-|?X-ooo--XB-?B??----?X--X-Bof
--oX---BM-X-EE-X???EXo-?--B?E--oXoB----|?ooE-?BB?T?XBoBo?-MB-?E?--B-B?|--B-EEo-XE?--B--o-??EX-EBoMoXM---X--ooBo?BBo-?--EooEMB-B--X-BX-Bo??oXBXXB--ooEB??E??oB-X---XXo?-M?-?o?-oE-B-o-X-o---o--M--oBBEXXf
mXXMX-oo??-o?EXTXoBB-XTXTM?--|BX-ME-o-ooo-X??-?-MM--M-o---?oMoo-o?-BMBoX-EBB-BooMB?ME-?-E---o-MEXEEMBXBX?--M?M-BB-|B-oX-oBEXoo-??--BoEX--oX--?---?XM-EXB--BB-?X-?-BXB-X-B-ooTX??B?--oX-?-ooB-BB-X--XX--X
X-X-X-XXX---XX-XX-XX-XX-XXXXXX-XX-XXX-XXXXXX-X-X-XXXX-X-X-X-XXXXXXXXXXXXXXXXXXXXX-XX-XXXXXX-XXXXXXXXXXXXX-XXXX---XXX-XXXXXX-XXXXXX-XXXX-XXX--XXX-XXXXXX-XXXXXXXXXXXXX-XXXXXX-XXXXXXXXXXXXXX--XX-X-XXXX-X
