-|-M--o-X-M|E-?B--o---------T?----B---T-TXX----------B?---M-B?-ToE|----B-BooM--?-------------MX-----Eo---------E-M|B------|-?-|--o--T-------M--TE-B---|oT---------T--?M-X--ET|-E--o--E---o?-----?M--B-|-
---?---M--TM|?E----o---?-------|-M-oX---T-?X-M---B-BM--TT-------EE----|--M------BB-B------?--E-------o---B-----E?-M-B---X-o-----T---X---E|----M--|-X|B-M--------T-?--T|o----M-----E-----Bo--E|--------o-
-E|--------?o--M?||XBMX-o---M--TEo-------EE----o-?--oB-o?-E-XE-|-------|---Bo-E---M|?-|?-----||-T--TT--B---T-E-o--------E----?E-?-X-----|-M--EoX--?----|--E-E--------|-BBB---E-----?-E---T|E-o-----M?X--
---TM----E----M-B-TT--MEX---MEEME-T-B-?o-T-T--|-B|--EB--M--------M--B-------M-E-o---T-o---|--M------T--|BX--------Eoo?----T-----|------?oXoX---TB-----M---------|-?-X-----M-?---|Mo-----B---------------
-------XXM-X|---E--E-E--o-TM----EB---------EB-M-X-T------B?--To?|-----|--BBX-E|XE-----|--T-E------E-BX-?B--X-M?---T-Bo--EMX----Bo--B---T------E----|-B--T--B--oE---TEE---|BM-B---o---|-E-o--?---------|-
----MM--E-M----o|M---?-?-----X--M-E--M-----BE-M-BE--T----?---o-E--E-E--EM--E-o-?-o-----|------o-T----E---EE-E----T-To---?-----?-T-M|--------EB-------------BE-----MoB---M|TB------M----T?M-Moo-X-M---o--
--o----T|-M--------o-||--B-------M-M-T-Xo-M-T-?TX--ME----M--------o-----MB-?----B-?-o-X-|X?--?B-----------T--E---EM---T-T-E-Xo---T-?--ME?X-||-|-Xo---o----o-----?-----oE------B---X|--EM---E-M-E-|--E---
---XB-----M--------X?---oT--B---B-|?T-----o--T?ETXoo----o-X--M--?----M--BTE-o--|-M----|----M----BT--BoETT-------M---TMo-----MBT?o----B--------X--X-------|--?B-------?TXo---|?-?B-T---XE-T-oET----M-|--v
-E---------------T------X--|-o---X|o-------X-T-?-|X-M--B-X?-|-ME-o?oX---MoBX-|-T-XoT-M?E-X-o--E-E|E-?----------M?-T----o|M--?--M--M-o--?o----M|EX-EMX-------------?----|--T-B--B--oX---?--?-----B-E-E--f
--M--|-X--?||--B--?o|-TM---T-oEEB--B----BXBM---??M-?----o-?B|----T?-X?--?--|-M-M-------BB-B-|-?--|--?-?--------M?----MX|M-BB-B----?---------?--X---|------|-E-o-oM--o-|-?o----EE---E-?B----o-B-BoT-T---f
-M--BBEM---?BE-?-|------M?----B-----|B-o|E--M-----EE|B-----X-------|B--M-------|--o--??--TT-----MXE---BE----ETE-o------B---?--?------M----|?------E?----B---B-|-?|-----B---?|--o-M-oM--|-?---T-o----M--f
--B---?-X-TB-----E?-----X--E---MTM---MX-----B--o-B--?-TE-XT|T-M|B-----?----o-X-----X----XX-E----o----TT--T-o?-------E----|-------|E---M-o?T-MT---E-MXo-?----------------o-?---|-o----X--M---o--B--?--X?f
-|XB-E----T-E-------ME---BTT--?--XTTXXX--?---|--|--X---E--X--B|--?T-o-B---EM----Bo-E-|XE---------E---MM-o-B?-|----o-T---------o--E-X---M-XT---M-----BE----E--MB---?---o--X----EMT-----o----B--E-|--?o-?f
-------M----oEM-B-E-|-B----B----X-?E---Xoo---?MM-B-XT?EX----B--E?---BT-B---X---EB--M|---X---X--ME-------------|-E--M--EE------------E---|XME-X---|---B---XX--X--T------M-?-X----|-T----XB------|--M-?T-f
m--X---?B-----T--|---?-EX------||T-T----|M-o----E--|---o-?----E----B-?--?o--E?-?E-M?BT----Eo--BM-----T----X---o-------------B|--T|---X--|----B-------T---EXEB-ME-oX-T--X-B-B-M---o------M-----M---T-M-oX
XXXXXXXXXXXXXXXXXXXXXXXXXXXXXXXXXXXXXXXXXXXXXXXXXXXXXXXXXXXXXXXXXXXXXXXXXXXXXXXXXXXXXXXXXXXXXXXXXXXXXXXXXXXXXXXXXXXXXXXXXXXXXXXXXXXXXXXXXXXXXXXXXXXXXXXXXXXXXXXXXXXXXXXXXXXXXXXXXXXXXXXXXXXXXXXXXXXXXXXX
