-|--o-|---E----T---B----TM-------------|-----E------B-------|-----------B--B----ET----o-E----M--|-----X-E--o----E-----------?---M-|-?--|-----|-?-B-T--B--T-X---------|--T------BMTB------------B----B-E-
-----?----|--T?-??--B-------------o-T--T--EE-TXE?---B--------M-E----|--T---?-----o-?-?----------T---E---o--?-|B---M-?TXE-|---X-------XoXEX---------|--T-o-B--|X---X---o---M-X----X-B-T--E----T------B?--
-MX---------B------B--X--B-------T--?-----o-B---|-------M-----------?M----B|-B------X--M---X-B----T----------T-E--BX-M?o--|--??-----o----B-----X----EX----------M--M-X------oo--?--X--T-X?--?-o--?B-----
-M|--------|--?oEX---M--E---M--M-?----B-------|---E-B------Eo-E--E------------T-E----o-XEE---X-?-----------------M--BEX--E-o--?--|-----M------------|--T---E-|---BB------EB?-?B---BT-BX-?o-||-----------
-------o---------BoT-M--EoTE-----B-T-X--X-?o---|--XoBT-|--oB--|--|M?-B---|-----------M------B-----E----?---oo------?---X----|-|-X-|-X|?-----E-T--?----|E-M-T----E----M--T-----T--B-----M-----T----------
-X-o--?-B---ETM|-B-B-B-M-------o-o---|-X--o??-o-?-o-M-o---------------T?--X----oEB-?----|------B-B----------?-E-o?--oT--?---|--------XE-M--|B-X---E----BB--E-X---E--E------M----oX-B--o----MT-----?-----
---|---X--E|---|-?--|--o-X--T---T-B-----T--?-X-M?E---|---o---o---------X-|T------------X--oB--o--oM-TBM-B--EX---------EB-o---o-T----TB--o-------M-|?-----T--BE--TT---ME-?-----------------o-------o-EX--
---oo-B?----|----------oME---------E|M------T---M---T|-o--Bo------?-------------M-MT--o---o---E-MM-----BB--------?--E---------X---T-----B-?------o---M-E------M----E--------T--E-oE--E-----------------v
---------?-----M-----B?---|--?--o-BE--T--?--------------MEo-o-----E-------?-----BE|XB-E-------o--XM-X---------?---X-M--?-?-----------BT|M|----|M--|-E-----EXTTB|---B----oBE--E-----X-----o----T-----|B-f
--o--------------T-?|---M----X--o-E--M------BE--------|----------T-BE-o|---T--B----??---?----E----M-----------MM---MM----EE---B------?--XBo----------B-?E-|o?--E?--M-|----|-E--MX----T---------------T-f
----M-|---|------Bo--M------------oM----?-----|---X-X--o------|-B----T----?T|B--oM--oo--------X---o------o-M--M-------------o----o---------X----EMo---E--T----------T-|----XMo--?-M-o-B-?----T------o--f
----X-----T?--X--|B-|-?---XE-M-MX--BB-B--X?--B-oB--?T---|------Mo|X-ooM--|--o-T-----oM|-|---o--------------M?--|---E---|------?----o-?T-----TEo---M--BX-?-----B--B--------E----E-T--------B-M|--------Tf
-T-?|B--EE-------BT--E-|-?-X---B--T-o----B-------M--------B-T-----o--------T-E-X------B-TXB--M------B------------T---TX----|-X--X------o--------|-M-----?-T---|--|--?------?--X--o-o-----|M--B-------o-f
-XB--M---M----XX--------oXo----XBMEM---------M--?-E---?--o-B---T----?----BX|MB|-E---E----------|-----|--E--BTM---XE----EE-XE----B-o-|XM-X--B--TE-M----M---M--X------?------X----E|-------E----T-o?B----f
m-----M?-?E-------M---?--B-------------TB-M---??T----T-------X-?o---?-B----oX---T|M------T---------T?-?-----------MM-X--E-------TT--T-|?oX--|B--o--T---B--------?o|-------T--E--o----X----o--E----o---EX
XXXXXXXXXXXXXXXXXXXXXX--XXXXXXXXXX-XXXXXXX-XXXXX-XXXXXXXXX--XXX-XXXXXXXXXXXXXXXXXXX-XXXXXXXXXXXXXXXXXXXXX-XXXXX-XXXXXXXXXXX-XXXXXX-XX-XXXXXXXXXXXX-XXXXXXX--XXXXX-XXXXXXXXXXXXXX--XXXXX-XXXXXXXXXXX--X-X
