-----o---X-X--XM?---X-M-?----B----X--Mo-----?-o-E---E----oE-o-M-M--BM---o-X-B--XE---o---?E-----------o--o-EX----M--o------X---X----?---?---?E-B---------E---M-?-BX?--B----o-o-------------B-XX--MB-MB---
--?-M---------?ME--X-o-BB-----E-BB---E-X-----B---E-oXE--o-------E-M------BM?-EEXMEB-o--B---MXBM---------B---XX-M-X--XM--M------E------o---X-Mo-----------Eo-----XX-E-MM----B-M--?MXB-M--E-E--?----XB-B--
-E----o-M--E-?----X-B---M-EM--X----------M-?-?oM-----EMo?----E-o--M?---?-------------E-EM--M-E-BB--------E-o-oM--o-Eo?B-Xo-M--oXB-----------X--ME---------E-----X----oX------MB----B----B-----EMo-B-----
-X--X-ooM----X---X?-o--E--B-----?---M-B-----E---E-B----??---BEo-------M-o--B?BBBX----E-----E---B--oo--?X-X-----o-E-----BX-B-o--X-----B-B-----o------M--o---?M----?B--------X--o----?-X-------?o-----E-?-
--------?-o--?---E----E----B--??----EE--o-----M--o-B-----MMXEEE-XXB----M----X------Bo--EM-E----o---?----B---B----?-EM------MXE---?------------B-o------X-Mo------Mo-MX--M?-?o---M-----X-?B?--??-----?o--
-o-----E-X-?-MX--Bo-MoXX--oX?o---B--o--E-B---E-----B-E--------MM---------E-oM-------E-XE-M?B-------X-----?-----o--E--?oX-B---?--XoXo--?--------?-X-ooX--X---------?--o--M--BM-E-------------------XM----
-E-EBE-------o-------XX-E----?--o----B-------o-E--B--E---XMXB---EXX---?---E?-X-BoM-B-?-X----------M----M--X---B--o-MoX--------M--Xo-XBEBX?X-E-X?----E-oXE-X-X-B-XE----o-o-??o---XB-----M-?--M-B---X?--E-
---------M---Eo-oBE--?-M-E-o----MM--B----------M--?----E-----X-?-o-BMMo-------X--B---MX--o-----X-o-MXoX----M-o---X-EMB--X-----BE-MM?-----BEB-M----BM------B-X---?--o----B-EEM--M-----o-X-o--------XE---v
--XXX-BXE-X---XB-M---------X---o---------B------X-----M---Eo----BB-B----o---M--E----o---E--E-------B-o---B---X----?-?o-----M---------B-B---M----E-?--E-ME-MoB-B--M---X-X---o--M-MX---EBM--XMM----M-----f
---Mo----?-----o?-------oB--?------B--E-MoM----B-o-M------?o--B-?----ME-oX-XX-X--B--X---?--?E-o?---MB--?-E-?--E-E-o??-XB-BX-?--B-----oo--X-------o---B-M-----------?-oM------B-X--?E-??B----Eo----B----f
---E-E--oM---------------MX--B-------?M-o-?B---?-o?E--E-o--o---M-Eo---?----oX---o-B?--o--?-?o?M-o-M------M--?-------BoX--X?M-?--XE--o--o--o-----?---EEB--o---EEBEo?-B----B-E---o?--Eo-------B-MB----E--f
----EM-o----EMXBB--E-BB---B-----M-o--E-?E----------M?------ME----?------o----B-----M----X-oo--M-BM-?--X---B-M-------o-XE--?E-B---X-MoE-M-?-?-----E-----------M?--X----Bo-----E---o---X-M----E-X--o--X--f
----X----o?---------E---o-B-E--o---B--?-?X---oB-----XB--?XX---M--MBX---o---?M?-??-EEM-BB---o-------------oB-E?---o-------M?-X--o-E--o-oE--E--o---o---------B------BX------M-M?ME-E-Eo-E-EXM--M--E------f
-X---?-BX-oo-E----M--o--?BB-----?--o-o---BoXBoX?---?----EB-M-X-E-XE------??--M-E---X------o-EM--B-EM?---ME--BX----------?---?--B------oE-----o-E--EX-B-?----E--------?--?--??M--oo--E-MB----M--M-E-----f
m--------------------------------|--------------------------------------------------------------------------------------------------------T------------------------------------------------------------X
X---X----X--X--------X------X--X-X-----------------------------------------XX-X-X--X---------------X----X---X----XX--------X---------X----------X-----XX--------------------X----X--X--------------X---X
