-----------X-----o----------------------M--X----B---o-??-----------X------o-X----Bo---------?------------X--Xo---ME--M--X-----MM---M-------E-----?XB--------oo-----X-----------------------oXE----BM----
-------M--------X---E------?-------?---B--?--X--M---XX-----------------B--------E-------E------o--------M----o-?----------------E-------------------o----?---------o-----------o-----o-----------M---?o-
----------?X------?--XE---B-------------------B------------------o-------------o-o-------------B-M--B--M--B-------B------M---------M---E---------B-X---------E------------------------------------------
----B------X---E---------M------X--X----oo-----------------X--------------------X--o-------X--B---E------B-------------XXE---------o-----X----X---------------M---------?--B---X------B----oE------XB---
------------------E-------?-----?---E---------M----------------------------------X--B--B---M----------X---o--o-?--o------?---------?---?--B-X-B--X------------------X-o---o-----Xo--------X-----?-------
---------------M------?-E------------B--------------??----------B--X----o-----o-----------------?-------------o----X--X------------------------------X---E--------X---------oE--o-----------------------
----B----M--------B------X-----------------------------o------?---B------BXE-o------------------------M------------------E--XM------------------------o------X-E----o-------o-------------o-o------o----
----?--------o-----M-?--------o------------------o-------o--------o--M------?--B---E------o------B?---X---B-X--o-------?----M--X-XX----XX------------E---------EX-M----?X-------------------------B----v
------B----X------------?----o--------------o------B---------o------------------------B---o-E------o------------------M------B---X----E-------E-----?------B---?---------------M---o-?-?-------E?------f
--------?----X---o----o---o------o--X---------------B--o-oX-----------------------------------------B--X---B-----M-----B--------o-E--------B-------B---------------M------?--oE---------M-------B-o----f
--E-----B--M------------o------------------E---M----o-E------o-----X-------o----B---?-E-----?---X-------B----------X------X-----------MX------o-B-E-o--E-?----o?-----------o--?------------------------f
----X----------------?--------------------------B-----------------Xo-XM?-----------------B-B------------------------------------X---M--o--------------E------------------M--------o-o--X-E---o----X-MX-f
-------T-T---T------oM----o----XB--M--TT--EoX---M-?-|----o-EB-X?----?-------XT--oo------?XX-TT---T--?-T----E-E--E--?T|B-EE----X----------TBM-XB--X-----X------X-TX--E-BT----T?B-|-B-B---TX------?BX----f
-------E-|E---|-T--E?---X--|-Eo--||-T-|-T--|-|MXX------T||--o|---ToXBT||?-T-|--|E---|-E--TT|-|-EEXTMT----|---?-----|--T--|X|-M|To|?-T--|-|-E||---B--|--XT------E|To||-|T?---|-||--|T----|o--T--|----|-|f
m--------|------T-?--ET-|E--X-|T-----|T|----|-||T|-T--|-TB-|||---T----X-T-|-|--o|---|-B---|-X---||-||---|T--|--|--o||---o---||--|----X--T----T-o|E||?-|---|||-XT||-o-ToT--||----|To||-T|T-T-B?TM||---E-X
XXXXXXXXXXXXX--XXXXXXXXX-XXXXXXXXXX-X-XXXXXXX-XXXXX-XXXX-XXXX-X--XXXXXXXXX-XXXX-XXXXXXXX-XXX--XXXXXXXX-X-XX-XXXXX--XXXXXXXXXX-XXX-XXXXXXXXXXXXXXXXXXXX--XX-XXXXXXXXXXXXX-X--X--XXXX-XX-XXXXX-XXXXX-XX--X
