----X-MXB?X----T--M-|?-M-??M-?XB-|--Bo-o-oMBB--?---??o---o-B-----B-----B-B-TX-X---B-MT-XET--o-E--BM--XX----B-X-o-B-MBX??-B|?--ETX---o-?|---B---X------B-X-M|----B-----XB-|----oE-?TXXo--oB-EXE-X?---X|--
--X---T----?-oo---X-EE-?-BXB----X----?TM--?XE-------XEM-M-M-MB--EMM?--|-X?B??B-??Xo------BBB-XB-BM---?-?-XXoB---MoM-X--M-BX-B-o-oB-B-XoBBoB-X-o|---?---BoEX-B-E---|E---oM---X----B-X?M--?E?-BE-o----?X--
-X--?Eo-o-M?---B--B??-M-?X-E------oo-----|-B-MMoE-o-|-----B--X-MXoE-B?X-----?oB--?--o---XXB--B-o---|-To--MX-----X?-oB---?---o----XB---X--|o--X-?T--o--XXoM-E?-BM--?|-BB-X-----?-----BB----M-MEM----XBo?-
--T-|--X?--XB---E-?-MBXX-B---E?----M---X-o?oo--?M-?o---XB---B?-o-o-o-BoB--o-??-X-----?-oB|---E-E?X-------B-?------T?-XT--MToB-oMEEo?----?--?|--ET----------X-E---B-M-o-o?o------E---EM--Bo-----ME-?---o-
-o-MEX--oBoXEB--E--oX-----EXBoB-|---M--?--X-?-|BB?TBo-MB------B-XX--|--?X---T----X-----|---BM--------E--M--|X-----E---B-M-|-------X-B-------X---?-?B--?oB|oo?--?o-oToE?----o---M-?-o--E-??BM--B-?X---?--
--M-E------B--XM---MM--B-Xo--BBM---XB-|?X--XM-B?BBX?T-?X---E-T--X-B-?---oo|-----X-------BX--XBB-B|o-BXM---M-EBB?XEXM-E-BXXT--?-M-oB---?--E-M-oT-------MB--o--BMX-?---X-M--XXBX?-EoXB-oMBXBX---o---oE-??-
-?---T-|?---???X--E---Eo-EBMT?XB-X-XXo?XB-o----X-XB---B--?--o--X-----?---B?--B-oXE--X-B---B---B--?--T-MBXXB-o-?--?X------Eooo-B-|-X-XE?XX-B--?|---?-o-T---X?oEXX--Xo---TM----o--M|---BB-X-BX-----M-o?---
-----X-?------------?--|-oX-o--BT----T---Xo-----X?MM-E??-XX-XX-----M-M----?-----?|-|--?X?X-BB--XB?-o-B-?-----XXB-o??--??X--T-XEX-M-B-X--|M??-B-B-ME|TMXXEB---|-?T-?-o--TBB---E----?-E----o-E?---X-?X---v
-??XTXXo-?BX--M-XM-B|o---|M-----oX--?--X??-B--?o--?----T-B-B--EoB|--X-?X---B-|B-B-X---XXEEE--?-Boo----XM-B------Xo?-EEM-BXBX?B-?Bo?---------|-M--o--B---XX--X---M-MX-B-----o----|?TMTo-X----oE-B-----o-f
----B?|o|o-M-XBX-----o-E?-X-o-M----?B-XBXB---E--?B-?-E-MX-----X---X-----??------oMT?-M-MBMM--XB--M-B-?-?-|-o|--XMT--X--BBB-------?E-----B-XE-MBoo-?-B--MB-X-XX--X-BM-----o-oBT-o------o------MX--X-----f
---E-Mo--o--BM-|--XB?X--E-----?M?ToTT-XX-----ooXM---Xo--?-X-X---E?-?-E--B-X-BX?----MoB-ooXo-----X---o-M---o-|--XM----XX?T-B-?BME-E--?E------oo---?E-MX-----XBoT?oBX-M-X-------?---B-XB-o---X-?E?E-X-TBTf
-MMB-B-X--M-o-?TBo-BB----XX?----?--||?X---XM--M-o-|M----M?--XB-BX|------E---|?-?---?X---T--B-BTX-?B--o---XX-?X-X-B-M||-o-BE-TM-XB-X-X?---?--X-o---M-B|-o-?-------XT|-X--MM--X-E--T-?----E-X--XXo--o---Mf
-B--o--MMBE-BBM-B--B--BXX-----XMoEB-BX-B?--X?BB--oX-B--|E---XBo-o---o-BMX-B?X--------X---E---?T-o-BM--o?--X---o--o-----o-B-X----o-X-|?-BB---?M--?XXX-E--T--o-?-E-B-E---EM--|?M-X--E-|---E-|--BE-|--Bo--f
----o|--T--X---XX--?--E-TE-X--o-B-o-|----M-?---------ME-oE--Bo--T-T-?X?-----TMXXEo-?-?--X------?--oo?-o-----?BEXMoXE-oEoM----oo--X-??X----???E--T--o-o-BE-?---oX?TXB--X-----BX-o--EX-MMoX--?--o?E-o--??f
m-X-B---B?BM----|--M---|-----MBT----E|-XoXoXM-M-Xo--M---Mo--E--X--X-XX-|--X---M-X-M-o---E------X--E--MX----?o-?X--?-oTXX-Bo--E---TXX--o--B?-Xo----E?-T--EB--B-?-B---?B??---M---?----o--M-T-|Moo--E-----X
XXXXXXXXXXXXXXXXXXXX-XXXXXXXX-XXXXX-XXXXXXXXXXXXXXXX-XXXX-XX-XXXX-XX-XXXXXXXXXXXXXXX-X-XXXXXXXXX-XXXXXX-XXXXXX-XXXXXXXXXXXXXXXXXXXXXX-XXXX-XXXX-XXXXXXXX-XXX-XXXXXXXXXXX-XX-XXXXXX-X--XX-XXXXXXXXXXXX-XX
