---E----o--M---M---ET---X-M---?--To----E-----T?-TT-MMT-E---------o-|?-M----X------E-------?------T-|?--T----T?Mo-E-?-|o-E-----X|--|E-?--M---------Xo|T-----X-?X---?--B-----X--TTE--M-o--B-B-----X-B-o---
--E-?oMT----TE-X------E---T----oTEX-----T-BX--o--oM----M-|---EBoo?-M--?-M---X---??---EX-B----o--EB|M-B?---|--M-M-----|-----?--|BM--?XE---X-|--ME----B-----XB--TM?------oM-MT-o--?-------------XT---Xoo--
-----M-|T|B----?----T-B--oX-|--XE--MMo-T---TME----BX|--------o--o-TT---|--XM-E------B-?T?--X-XBX?M--o-?---Xo-X--E-|-B--TXo--X--MB----|X--T-ETBX?----T--|-To---B?--?o--MET--|E--------X-----B|-BoE-|-----
-----T--?--o-----?-----?---X-MM?-M-B-o-M--T-------B--E--o---E----T-MMEEMX--?-oX-M----XT-T|B-E?T-T|----MXMM--o-?--E-------T------M----XEE-----XT-M-oXE|--|------T-o---M|?E|XT-E--T---T|B-TB-?-oX---E---M-
---X--BE-TM---?Xo-X-?E-B-B---M-|o-Mo--TTBo-?X-X-?|--T----o--------EE|----?-----Mo----ET---------o-?---B-E-------MBBX?-----M--------o---|------|o-X----X-B-M-|-----?----------o---o-X--|--M-?------MB----
---T------------o--o?BBX--X---E--?M-M-oBo------XE------|T---o-BBE---o---|------|T---E-?--MM-X--??-----T---o-B--B--E--------------?EEE--oo-ToT-----X-M-B?-o--oB------?|----------BET--?----------M-----M-
--|-ooo---|---E-o-X-|------X-M---TME-BX-T--BToo--?-E-TT--oM-M-o-o---|---|--|-B--------XB-BM-oo-EEoM----E-----o--o--oM-----?--ET--BB--?---E-o-------?--X-?-TB-T---?X--E?BM?--------X-------TT|T-----BB---
-?------E|E---X?---|-?-|---E?--o--T-o-X--oE-X-?X--XB-----ooM------|TBB--??-X-E-?-o-M-E--EXB|-?-?T-oo-X--T-E---T----?BM|-M-?oB--ETET-T-M-?---B---BXX-XB-----M----------------M-|E-----?---E--E------Eo--v
---|---------?-X|---?M--o-|-E---X-----o--M-oE------X--X-BXM-Bo----|--EMX---ETo---MT--T-o---T-----E--T?|----o-B-----M---B------|---TX-E---B-X---------X--|--X---M-------o-----------Eo-oX------BMT--B|--f
-?-----|-T--|--|--||-XE-T-----X-B------M------------X|B?-|EX--o-T--T---TBT--X--X----B-T?E---------B---B---MEE---BB-M---B|-------T-T---?XT?--|X-TB--oo?T?----B-oT-------?MBX--B--|---?-|---M---B-----E-Bf
---E--B-oM--o-|?------------M-M-MT|TB-oE-|--ET--BE-------E------o?-X--E-?EE?----|-|----?MEo-X----B-|-------XT----E-|-|------M---M---X-T----------TE-----o-----M---EM--E-T--ToXX------E-T---X----X-----?f
-------B?--M-|-|----?-BM-------XB--XM---?--TX--o-----X-?-|-----?----|-----EoEM-X?X|------MoE-|-----o--?---|---|-MM??o--X-M--?|-E||-?-X--|-------E--EE-----E-----E----o----TT---T--M--|M-oB--?o---|---|-f
--o---oB---?--B--X-T-o?--|----X-------M-?----|B-----T--XT------EX---?-----?-?-o|XX--T-----E-?-??X---?--------X----B-----E-B---------|E--|B-o-XB--E---T-BB?--M--------?------E---o--E-T-|----o---X-T---|f
-?--T---X----M-----Xo----oE--|??------?o--X|M-----T-------E---o--|--o----T-X--|M-|X----TMT------XMTX|-----M|?B-BB-?--T-?----E?------?-M----XE-?-EM-----------XoXE--M|-?M---M|-|-X|--M--o---X--To--|-|T|f
m--?-|----E-----Eo-------?B----M-oE--??--T-B-B-E----B----|--X-?------BE--XoB-?|----T----B-B---|E-?-B----?X---X--o----BEo----X--|T--o--B-----X-?---M--E--?-M-?--BBTME-------------------T------ooo--oo-EX
X---------X---X----XX------X---------X-----------------------X------X-------------------XX---------------X-------X-----------------------------------------X---X---X-------X-------X------------------XX
