--T-|XT-TB-E--X-?---o-oBXo-?oTMoT-T--To-XX--EXXB-B-?TM--BMTo-E?oT-TT-|ET?BTX--TM-??T|T-o---oTTB?o--T-o?T-oEo----|TX---oET--o?-X--oMM-|MX?-XETB-MXEToXXTo--BT--B----o--X-M-?M-oXMBET-o-B?-TX?-XTM?Xo?BMT-
--T?TEB?X-T|-X?-TX---?ET-??X--?--Xo-T-oBX?-MTT|-?-ToTETX---TX---XM|XB-o-T-Eo---?oXB?-?B?||oM--oX-B-B?-oT-E--o|BoTMB-TXo|E-B-Eo|--?TB-M--oTEBE?M?o---X-oXTTETTTTM-|XT-T?o-ETTT--?T?-XTT-TXM-M|T?oMX--T---
-M--Xo-----|----TT-E--BBo-TTM?-E-BoTEoE--EX---T-T-|T-EE-oXX?-XTT-----MT------oX-|XTTB?MMXXTTT-?-B|-?oM-M-oX-To-|-o-E-BMo|-|----X-ToooTT----M?-oT?|?-XX---T?MToXT--BET---oTT-o-Bo-o--oT?-T-TXMo??-XEXo-o-
-oXTT-XX?E|-TETE-E-oo?BToT?o-|---T----o--X?-T-oB-Xo-TT-BT-Too-XEoMoTM---?X---|o-ooXo-?BoXXB-MT-X-TEMoT-BEMT|EXXo?-X-?--BXB-Eo--T|BEMToBoBo--T--TTTB--?X?-XXBBMo-TBM|oT-BT--X-?-?TE-?XT-?-X-T-B--TB--oTT-
---T---TTXo-ToXBToTTBT---TMoT-oXX--oBoBMTE-XX-X?-ToXMXoTTTTEEEo--B---TT-M-TX?Xo--X--ToX---BEXMoT-?M--XT-XMToT--TToX?oT-TBTT?ETToEoXTE--B?-To-o-ToBoXM-MXToM-oTToX-o-T-Mo-XBE-o-oo-XTT-ToM--MXM?X--TT-XX-
-ooE-MM-|--?-TT-?X-o?XT---T--oXX--o?X--MT?TM--?X-B?T|-?-TT-BT--ME-T-ETX|-?o---|-Eoo-oB-TT--oBMTTTBE-?X-T-X-TE-TTTTo?--T?-oo--XETXX|o-?--X-EEE--oTXoo---?T--EB?o-BT-oT-o-?-TXT-X?T--?M-MT-TEMMXBoo-XX|B--
-oBX?-TE?T?T-T?o-Xo-X----TTXEXTT-XoE-o-EEoM-XT-oE|T-T--TMTBTE--MooTTXXX-TX-M--XoT-BX|T-?BT?BTXo--To?-M??E--?TXTT-MMX-XTXTXXET-T-M-T|o----BM-E-o---o|o---To|X--?MT-TT--T-TTo-?oTXM?TTT?BB-TMMoETTXT--BBM-
-T-TMooTo-TM?o--oTX--T-MoTo-ooE?o--BB-oTXoT--X-X------XT--MMoMETooB?-o--BTBT-o-B-?-o--M-XTo-T-XX-X?o-XTX?Too-oXBo|oXoBM?|TMT?TTo?|--To?-XoT?BT-B--TMMXXEoET-B-|BTo-XT---o?TT-|BXo-TT-ETXTT-o---T--B--X-v
-TB-XMEX-oX-o?BE-B-E-B-XXB-T-M--EX?E-T-|oM-BT-oT-TTMX--o-TXXTBooBEE-oTT-TTX--BEoTTTBM-TETXoo-T----o-XE-TE|-X-?E-oT-|oT-oEM--T-o|ETMTX-B---Bo--XTTMMT?TT--M|-T-X-ToXTMEE-|-BXX?TTT-BTT-ET---XoBXoTT-T-Tof
-T--X---B-T-ToB-X-X-MM?BTToME-oX-?-X-TT-o-MT------ETXME-TB-?BTTM---TX--T-X-E?-E-T-|--o-?TMTT------X--EoTB?Xo-ET|TE|-X-XXXoBXo-T-??-?-?o-?TXT-?B-Bo-TT--|---X-|oo-|-BB-----T---X-T-?---TTXE--MX--M--?TXTf
-MT--XBMXX-XT-TT|T-oT-M--o--o--TTEXBT-XoTo-B-X--?-?BT-T?T?-o--oT?T-|TBo?o-T-X-TB?T--oXT?X?-?T?M--X--TToET-T-MToT-T--T--XTMTXTX--XTMMX--BX-TE--TTX---T-TT--TT-BXETT|-BTXB-XT-oBM---oToXE-oo-T-E?-M?TBMB-f
-oM-?T-XoEXo?TBMT-TTooM-B-TXMEoT?TT?TT--?-E?|-oTooBB-?-|B-|-X-EXMT-XoT-|TT-TTX|oTTXB?E-T-T---ooTX?X-MX-TT?--BoTTE-B-M-E-MTTX--T|-M?-M-TBX-|TT?|T-?EE-T-TT-TT?TooM-|oo|?-E-T-XToXE-XXTT-o-BoE-B----?--XXf
-XBB-?-MB-?--?BBoX--BoX---BBMB-XooBXB---o-M-XE-|--oB--XX-BBBX?B-X-X-XXEo-Xo-o--XX-Bo?EMoX-To---X-T-BBB-BTBooMBBXE-o-?-?M---XBX?--oB?--E-?-?---o--B-BBB-?X|BX-oB?X-EMBXXE?XXo-B?-BX?M-o??-BBMMMoX--BXXX-f
-EXoMoo-BEM--XBEMX-MB-BMMoB-o-XB--MXBoX--XBXMEXoXXBM-XX--?oo?-B-oX-?--E?BX-B----B--Bo-XX--?--o?--oM--?X-?E-?B|MEo|o-MM--MooET--BE---BXB-??-B?-BXooB-XMXEMM-TX-?MMo?MEXooBoXoBMB?-oo--To|T---X-X--?-?---f
m----BoBo?oBEEX-TM-XEMEB-MBBB--EoB-TEXB-oBMBo-o-X?E-EB--oX?B-ooB?B-M-B?ME?BB?XBE---B--M?-MBoEoX-EXEXXoXB-XB--EXoMXXMo--B?|-ooXX-EB-M?Xo-E--|-Bo-o-o---B-MBXE-BoB-o-??Xo?B-B-oXBTXoET?BX-E-XBo---XMB-?--X
XXXXXX-XXXXXX--XXXXXXXXXXXXXXXXXXX-XXXXXXXX-XX-X-XX-XXXX-XX-XXX-XX--X-X-X--XXX-X-XXX--XX-X-XXXX--XXX-XX-XXXXXXXXXXXXXX-XXXXXXXXXX-XXX-XXXXXXXXXXXXXXXXX--XXXXXXXXXXXXX-XXXXX--XXXXXXXXX-XX-XXXXXXXXXXX-X
