-----o----------T-T|-------o-T-------X--o-E---?MoTBT|-?-E-----------To---------?--T|BT--B-----B---T-?||?---MBo--EE??T----o----X-?-X--X-E---T----o-------------|----o----T---T---------EE-XT|--oT-T-|----
-ToB---?-MT-----M--B-----o--------TX|---|-T-----T-M--?----X-TT------------T---T---T---T--o---B----?-o--TE---TT--------T----T--|-BM----M?--E----o-o-------|-----T----?TMEB-M--T--------T---------o-?--M--
------oo------B--B---o----?X----T-------BT----?---------X---TEX----|---X-----T---ETTME-?---X---oo----Xo--??--T-o-?X-|-------------?--M-M---o-B------B--E---oBT--?----X-----------?-X--T----o------------
--T--EE-o-------B-XE--?X-|E--X--o---|-B----E--|------T----T--o--T----------T--oTT--?---------X--|-E------T----o-----?X|-M---X--?-T--X-------T-?X-o|--------X----T-T--?---MEoo---X-----E--T-----------X--
---B?X-T--T--------X----X-------T--X-----TT---E-B--E-E--E-------------TTE--T--T---------XT-M-------B-B---ET--B?-|??Xo----ET----?-?-To------X---T-|--T------E?--E--XT---------X?---BX--o----B-TT----T--X-
-----T-----TX----M--X---EBXT--T-B---T-Xo-|------T-XBEE--T---TT---XTT-?--T--T?T---?-oX--------|-----?--X---TT--T-X----T--------T------XT-X-?-T-----T----------|?oT---------M--MMT-Xo-T-T-?----------X-X--
-X---M-X-B-B--B--X-o-T---o--BX--oX-?B-X-X-------?-E-oT-----B---T-TM--B---?-------B-M----X-B-----o--TX-TT----MM-T----o-MT--------------o-o--X---X----?T-X-o-o-T-|-----M-TToE-E------T--M--T-B--|-o-------
----T--oT-Xo-TT?---------------XE----E--?--Xo----o-----oB-----o-X|-T--o-----------T--------?---o---E----o---T-B---E----E-------oT--T---TTT-MX-T-o----------XM-E---o-B---X--oB-------BX--E--X--Mo-|-----v
----o---M----B---o--o--------X-BB-?TM-T--M-------X---o-X--B-----MTT--X-------?----------XT------T----o-BT-------------o------?-B--o----B----X---TE-------T--------B-TT-o-o---To-----M-?B-?--o--X-------f
--oo---------M----------T---E------------|--X?----?--T------------o--T-------X---XMB---BB--|-T-o-oEX----?-T---------T--X-----X------BXT---------E--EB|-----------?--T----X----M-M-----T----X--B-----T--f
-?--T---T--?-M----M--??T--X-T--X-E|T--TTB----T-----T-B|---o----T----o-----------o------XXT|-T--------?------|----T--o-B---T-X------X--XB------B--------------X-B-?-Eo|-B--B--B---------MET----M----o--Tf
----?E-X-oo------o---BE-T--o?--BM------X----oo-----T-??----?--M-?-------XB--T--X-T--T----T-?--M----o-oo--|M---M-M----o-X---?---X---X--o--?------?------------B-T--M------B---X-?-T----o--X---Eo--T--B--f
---o-?oo|?M-?-?E??BMXMXoXBX-?X---BEo?-E--ooBoBooo-B-XX---EBX?-B??o?BEE--TB?-?-E??T?XooMoM-|X-?--XB?BB-BXMBo-B-Mo?E?BBoBBMBMoBE-XXEMB---B-oXBo--X--?X-E?oX-X??o?X-Bo-E--------o---BXMM-BXXM?oTX|BMMX-?X-f
-?X-B-oX-MXXMoXoB-X?----X-oX-BM--E?BXB-B?B--B-XX-MXMoXBXX-B-?--X-XMX--X-E---oBoX?oB-?XM--M--?-BXBBB-B--?oX-|X----M-XBXXX-BM-BoM-|oBXoo-M-?BXX?--T?BEoXXX?EB-??X--X?BBXoo-XB?B-??XX?BBoBM-MoTo---BooE-??f
m?X----o---MB?EBoBBo--M--|o-B-BTB-oX|--BX-oo-MoX-B-o--o--oX|X??BEXETX---XX--MMMoXB-oB|BXo-B?MoM-TM-?MoMX-B-oXoBo-o-E--oo-X-Mo-Bo-?-M-BE?EM---X|----To-?XB-??-o--oMM-MoXEBMB--|XXX|MM-?M?-TME--XoXo--BMoX
XXXXXXX-XXX-XX-XXXX--XXX--XXXXXXXXXXXXXXXXX-X--XX-XXXXXXXXXXX-X-XXXXXXXXXX-XXXXXXXXXXXX--XXX-XX---X-X-X-XX-XXXXX-X---X-XXXX-XXXXXXXX-XXX-X-X-XXXXXX-X-XXXXX-XXXXXX-XXXXXXXXXXXXXX-X-XXXXXXXXXXXXX-XXXX-X
