---B-ME---------Eo-X-----E--MB----M-------X|B|--TB--------?|--?--E----BX?---B--o-M|-M----o?--?--B--T-o--E--X-MB--E-|------B----oT---XB??-To-|--X---X----|-E|XB-X-Mo--|?------E--E--o-E-B----------?T----
---XBE-Bo-X-?-XM-----E---o---BoB-TB-E-----o----T--?o-oM--EB----E----T--?o--o-E-T-X--X--?------M-?T-E-------M--E-M-B---------X-BMTo---M----BB-B-M----BT-B-XTB|oo------X-X--X---M?-------B-E-o-----T--|---
-|-|M---------MoB-ETM-----B-M-BX---o-X---o-----EX---|-E-??-|--X-E-MM---E--o--ET-o----MT-E---------o----MB---E----T-M----|---?-o---?---??|-?B-M-|X-----B--?---X--ME-TM-X|o|---|EM---E-E-E--T-M--B-?-E--X-
---------TBo----M--?XBo--T--|-o-?o-------T----E---M----M-B--B------|M|-E?---??-EM|-----X---E--B-------EX--oT-----M-E-oX-------E-BT-|-o-B-|o-?----oE--------M?--B?-----M--T-----BB-----MoB-o??--XEoXET?--
-EX---TToT-----|----|XX---ETT-o-M---E--MX--E----EMBBX|X---------E-o---B?---o-ME---|-B|E-----?Mo-------B-M-BT------MB--E--E|---EoE--------o--T----------B----?|-?o--o----------|------o-To-|E-----X------
--T--oX------TX---T---X|BT-?-M---o---M-------M--o----B?--E----M-EMM-o-?---o|-X--T|?----B---?------X--?-M-oX-----------TX--XBT--E--|--B--|E-B--o-T-----XB---?BM----T|--BX-----E-----X---o-|E-B-BXE---?X--
--|--------?EE--o------?o------?B-E--M-------MM?B-|M-B----oETET|-o?X-M-o--B------o-M-|---M--T-?--E----X?----ME--E|X--B-T----oEM-T-B--|-----?-----?--o-|TB|X-M--------TB---?-M--|-|--oX-T--X--M-|-o--|?--
--|XM--|---?----?-o-----B-|---B--E-----|-o--X|-------E-|--|T-M----T?-M-EB--E-|-X-B-M---o---BB----T-?--?M|--o-T---M---X-TB|-?------o--MX--?M----XMBB--E--------BM-----B-?---E-B-M--MM?B|-M----MB---?B?M-v
--?M--E-T-B--E----oM-M-M-o|-------E----TM-----?Eo--MME--?----T|BBo-?BB---o?T-MT?----?-T-----MMo-|---------XB|E|-|-XX|-T--T---|---?-|----------XX-T---?-X-----|------M-MT?------B-----?-XB--o--E??------f
-----Bo--X---E------M-oB-----Mo---oBB|?---T-BM-E---o-ME?----B?------|-M--X-|XTXX---T---B--T-B-oXB--T--To-E--MB-------|---BET---|-TB-----|-----?----?-----?--??X----E---?----B--X---B--E--T-----X-?-B-EEf
---B------|T---?-X--|TE?----X---E?--To---T----o-B--o-o----|||--X------?-------|MT-oE---E----?------B|---BX---?T--E----B---X---X-B--M--X-E-E-----EX-oE-oX-----T--XM-T-X|---M--|--T|-Eo---B---E--E---TB--f
---o--|-||TEB-o--|-B---TTB-E----T--E----|------M-----E-?EXT------T--T-M---BB-B----|--o----|----??M?---------?-?----E|M---T-|-------------?------|-----X-o-----?--------TX--------B---T-Eo-M-X---------?f
--M-T---E--?-E------?-M-BE-oT---?-?---T------|-----B-E--E-?o--|M---Eo?--E---o--E|-MT-oM?---Boo-T--B-o--oB-T--E?---M---E--T--ET--X-o-----EX-o-o-T------E--M----ooB-|X--?-T--?X--B----X-o------MX-----B--f
-T--|-M-BB-----TXo-?--X-o-T----X----B-------Xo-|BX------|--?-o--M---|XEM----o-|---o--|M--E---?----X--o-----B-----B---MB--?|E-X----X------XM------BTT-oE-E--M-B-|XoT-M--|-T-?B?-T-?-|E|B|-?--T|-T--?----f
m----o-TX----------E-M----T?T--T--?oX-E?-------M--M--|X-E??-|-o-T--------o----X------E|ETE---T-----o------M-X-XE-E-------E----E---?-----XM-o---|-----o------B-T------X---?--?--|o---E---?B----B--?---?-X
X--------------X--X-----------------------------------X--X-----X------------X-------X-----------------------XX-X--XXX--------------------------X---------------------------X--X------------------------X
