--X----XM------------?------B-------?--o----------X---?-----------------------X--?-M-?-E--------------X-------M-E------------------X??-Mo-B?-------------------------------X----------------------------
-----X------------------------E-?--X--------XX----------------?--------?------------------EB-----------------X-------------------E?--M---E-------B-------o-----------X?---B-M---------------------E-oXX-
----?---X--X-----M-Mo-----oo------?-M----X--B-----o-M-?------------M--------------X---o-------------------X?------B?---------------------Xo---o-------o------------?-------B----|----M-|-----?-X-?------
-X---E--?---X--X--------o-----------------------------------XXE------oX--BEE------E--------E--o--------------E-----------o---------BXEB------o----------------------X-----------?---o--|B---------------
---E-o-M-------?--BX-------------X------?---------------X-----B------------------------------------------------------------M----E-------o--------------------------X--B--------B?B-o---------o---o------
---o------------|----------M--BX-B---?M-------?----------X---EB-?--------------B----ME---o-M--B---XX---o---X----------------XM-B---------B----X|------X--E-o-------------X?--B--|--------------B-B----E-
----?-E-X-------EX---------ME-?----------------o---o------?--------------------o--X-----X--------BEM-------E-----?----------X------------------||---?B-----B--------------X-----|-------o-------M-X-----
------|-X----o-X------------------B---o------E-EX---X------?---------X------------o------X------------B-----E--X--M--?------------X----------------------------------o?--o--E---|B---M-|-----Bo--------v
--Bo--|------?o------B--------o-M----o-B----E--B---?------o-|--X-B--------M--o---------X?------X-?----?----------------X--B-----o---------X----B-------M---------------o--o-----|------|----X---o--B--Bf
-----?|-------?-X-o------X---o---B---o-----------ooo--------|-----------------?-----?--------------BB-------E---?----------T-------------------------X------M------oB-T---|---?-|--X---|B-----?-oX----of
-X-------------?-X----------EX---------------o---------Eo---|-------------E---B?-------EB-----------E--------o----------X-M?M-----X-X-------------X------------B-o?---M---|-----|-----------o----------f
-------E----------------o-----E-B-|X-------o-----X---MEo|---|---------?o--------------X---B-X-B-----X-------?------------|------------------------B-------X---------oB----|----X|?----------X------B---f
-------M---TTMTX-B--o-----------TE|BTE?--||--?--E-----EX|----TT----?-M--M--B------ET---X---B----XE-T-----o-T?M---T-XBM--o|------oX--EM----T-----To------T|--------|T-X----|-----|-----B-----MT?-oX-----f
------o--|T||-||-----||-----T---|T|-|-TE-||XX---T------?|-?|TB-?|--|--M|------o--o-|M---M----M---B?---M-?E-|B-ET-|oX--E?-|T----MB-M----T--|--|-o|-------|--|--|-|-||---TE-|M----|------X-----|X--T|?E-|f
m------E-||||-||E|---||E|-X-------|M|-|--T|-o--T||o-----|-o-|-----||-B-|E--B----|-------o--|X|E----oX-?----|--||-|---E---||-E---|oEE----|-|-E|E-|X||--o------|--||||--X-T-|---E-|o--M-|----X-|-|-o||--|X
XXXXXXXXXXXX-XXXXXXXXXXXXXXXX-XXX--XXX--XXXX-XXX---XXX---XXXXXX-XXX--XXX-XXXX-XXX--XXXXXX-XXXX-XXXXX-XXXXX-XX-X-XXXX-X--XXXXXXXXXXX-XXXXX-XXXXXX-X-X-XXXXXXXXX-XXXXXX-XXXX-XXX-XXXXXXXX-X-XXX-XXXXX-XXXX
