-|---------M--B--?|B-|E-?--T-?---------|-?--------B-ME--B-------|----------?X--B---X-M-------M--------M---??--E----T-------E-o---M-------M--X-M---T---|---|-------X--M-M--B?---?----TE--B----?T----oB---
--T---EB|---X--------X--------B-------T---||-B-----o-----M----------X------|----X---M----X|--------T--B--------------ME-----B-----|-T------------M-|-------------M-------------B---X-X?---|----------M--
-?---oT----|-----------o--E-----o---------X------B-B-?--------o--oo------o-------M--oB--oBB-?----Boo?--?-?|E?T-o--?--o------------|BE--M------T-T-----B----B-o--M-E----M-E-X|M-----T-----T--||----T-|-T-
--------T---X-----?-?--M-------T---T-T--?-----E----------M---?---T---?MT---?T-TX----T--X---?|----B-?---E----BXBB-|------?-|----X-M-T---------E--M--?--T-X----T|-?--?----T-X---o---T------E--|------X-o?-
--T---X--M--------o--o--E--B----?-?-------ETT---oE------T-X-X--?o--E---E--o---|M----X?-T-----T--E-E---------?--?-|---?---|---|-B?--X-----o-M-E-M--o--M-------E------M----?-oo---X-|X|-|-----E------o??--
---X----o----M-T-T-T---TE-?-M----X---E------T--------M---M--B--XT-M---------|--------B-|----|--?XM-|---o-|--X-oo-M------|?-o-oE-----M-----|------?---M--|--E---M-T---M------X-------B--|?-B--T--TM|-----
---------------BXB--B---|-?--|----oM--X-T------o|-----|T----E--M------B-T----?----X-----X-?oM---|----T---B-E-o----------T--B------|-?--MT-------M-M---------o---B-o-----------?----------o-------?B--X--
------o|-------?o-Bo-------o--------?-M-X?----XE--|----X-------B-X--M---o-E-X?---o--|o-----MMoM-------X---------M|---X-?-T---T-------To------o----E-o-|---B|?E--X--o-o-----oX---T-M--XE-------|------T-v
-M----------E-?-----M|---E-E-o------B-----Eo-----|--E-?-----oB-XT------o-T----XoT---E--oBX----M-B?---|-E--o--E?-T---M----?X------E-B-B----X--E--T--M-M---o-X-T---------E----|--Bo---------|--M--------of
-M--X----B-E--T------XX----M--TT------X----E-?------X---B-B-----EE??--------o-T?X----E----TM----o-----X|---M-TE---E-o---?-E------T----M----o--BB---E--o----|?----------X----E----?---|B----MB-----TMo--f
---?----oB-----|--BE--B----E---E-BE--T------------X-B-----M-TT|B?Xo|---B--E---|--?----EX-----?|TE--X-B--Xo-o------------?-Bo?--------T-----?--o----------M---XB|------|-----o-TE------B-o-X-------EB|--f
-----B?-BX---o---T----------M-E-?T--T-----T----E---?----o----o------M----|--o-B----?------X---BXB-T--o---?--------M-----TX-|X-E---------------TM?-----E---M|-TX-T-----?-----M-X--M-BE------E------?E-E?f
--?E-o--|--Xo-----|-------------------B-----T-M-------------------o----?------M---B-M-----E------?--------ToBBM|---X-XE----EE-T------B-XM----T-----BEB--XX?----|-------o--------?--?--------T--B-E-----f
-o-o---XBT-B---|-X|--M-?-X-----||--T---T----X--B-oM--o------XX|------E-o--o----BM--M---------T----M-T|-Eo----o----------X--X-M---T-|?---?M--------------o------o|--|--?-o--------T--?------E--T--T-B--Mf
m-------------T--------------------------EM--TM-----------oX-X----?-o-------?-------T---B?--o--B?--|---|-------oTTE-o-T--------?-B-|----o--E?----X---E----------?T-----|---M-E?--B------TB---T-T-MT--|-X
XXXXXXXXXXXXXXXXXXXXXXXXXXXX-XXXXXXXXXX-XXXXX-XXXXXXXX-XXXX-X-XXXXX-XXXXXXXXXXXXXXX-X-X-XXX-XXXXXX-XXXX-XXX-XXXX-XXXX--XX-XXXXX-XXXX-XXXXXXXXXXXXXXXXX-X-XXXXXXXXXXXXXXXXXXX-X-XXX-X-XX-XXXXXXXXXXXX-XXX
