-------|-MT-E-MBTTTM-Bo--oTBXXEo-B-BT---oE--BM-TTTEXT|oTo--oXT-?TT-M-|-B-o-TXo?E-TT-B?MTT|M-X-BTT-|-MBTT-o-|EoTT---T|T??E?ETT-?XT---?TXE--X--B-TX---BTXo|M----M-??-Bo|--TEX---X-B----?X-?T---TToX|-MXX|-
-TBXo-E-E-XT-TTM---BXTMX-|--XX--T-X----BX--X-TM?----?TE-MXBToM----X-T-X-BoT--|-?BM-E-B-?EooBEEXB----T-??-?oT-MT-ToMo-M-XX-M--oTBT-E---TXBT--XEXXB?o--XB-o-?-TTEoTE?o-E|-T-T--E-oTT--?TXTT-XM?-MXTMX-XTo-
-oX|?--|o--T-?X?-|-T--T--T--o-?TBB--ETXBX|E-?---o?EoT-T?MM-?o-T-ET-M-M--|X-XoX-oTX-T|XT-XTEETTXooE-EM-oMTXo-Xo--oTXEo|o--T--?-To-EBBTE---BX------MMB-|TXET-BEoT|T-TToT-o-TBMToME--o--------oTXBXTToXEX--
-XTETT--B---MX|X-BE|B-o-T--oXEXo--EMT?-T-T--B-BT|X|MBX--E-EE-XMo--o-oToE-?ETX??TX--?BMX-X-To?|ET---oT--oToo-XoX-Mo-T-?-EoTM----?oT-----ooM--X-B-X-o---M--o---|XTo-TT--T--BM|?o----E--X?--o--XBEBMT|B--T-
-o-oBMT|--o|---TXo?TM----E?oM-o-o-oToTBo-X--XX-?o-Xo-BT-TEEXEMoT|EEXTBBBTXTE-oT-oX-T?M-MT-??oo-o|EX|o-oE-o-----BTTXB-TB-E-ToE?|TB-BX|--?--X--M---oT--MT?TB---B|EX-oB-ooo-T-|BE|-E?-o-X--o-XEX--?Bo-MXMT-
-BoB---TTM-T-B-T--?-|--T---T?TB-o-To-TE-MMo?TT-TXoXE?M-ToT-oT--M--o-X-XTMT---XB?--X-?BTBX-----oMXXo-o-MB-o--XTXE-X-T-TBXT--MXBo-XEToX--TT-E--TTTTT-T-BBBET|--TBTEX?-B---o?X---|-o-oT-ETTM-BT--EMT-BXT-T-
-B?oTT-----T-TT--TBTTo--oE---BoT?X-?E--B?EToo-|-To?X--|X-T--o-T-B---X-ME-XB-B-EMM-oETo-TBoE-oo-EE|--T-TT?X-TT-??TXX-?--B-|--Eoo?TTT|-TTo-o||TooEEooMX-o---XTTTB|-TXX-BTTM--E-T-Eo-TT-oM-Xo-EM|-MToM-MEo-
-MMoE?TE?--oBT-T-M?X-XXTM?B-BTMoE---o--TT-----Eo|X?-X?B--TTXMTXooXXoX---o-oo?-o-------MXE-|TXT---TT-B--o--MX-ToT-Eo|oTX|-oBETB?TM-XTT-TXMTEoo?TX?T--TT-T-TMXTToT-o|X-XT-BT?-B----M-MX|?M-BBX-XX?EBEX-TTv
-X--T|-Bo-TTXX-To-B--TX-XoXB?-E--ToT-o--------T--?-TT?ET||---?B-o--oB|--TETTM---XXX--o-T----EBBT?-----X-?B?-T-Mo-Xo-TXT---oTTTXX-MBoM--T-o?B---|EM--XTo-BoEXTT--o-MXo|o--?T--|BT--X-----T?E--oBM||T-|-Xf
-XTo?-E-E-B-|oM-X||--|X|TooXTTX-|TXooX-T-?T?X--T?oB--T?T-oTTT-MTBTT--MoM?---?EEoXT---T-T---?BTo-?----B-T??X-XoXTEXX--Too-Xo-X--MTo-?-?---XEXTXMB--o---M-?---o-TTXXX--B-XT-MME-?--?MMoX-BT---o--|--||M-Xf
----B---?XXX-o-??-T-BM---X---oMT-ooTB-?---XT-T---??-T-E?ETTBBX-EE--MXT--TX?-E--M-T?X-ToB--TM--M?M-T-oBT-T-oXXToX-XM-E-o-----|TXM--ET?-ET---TTX-X-|T-M-B-E-TE?TX---XB--?oo-MXXB-o-T?T--?|?-X-T--?--TX--Xf
---o--oo|T-X|?T-X-MTT---?Xo?T-T-oTX--T-?T--ooX-B-EoXT|T-?To---XToMT--XoMX-XoX-BE-B-oXT--X-?EE--X?-o-TToXTM---|X-|oo|--TTT?--MTTMTXT-T-?B-XToo?oBo-T-To?-XoETo--T?---?--Bo-X?-T-X---MTTX-T-o-o|---?--B-Xf
-BXXo?E?-E---BE---XXBBXM?MB-X-o?-X-XMBo-B?--o?X?------?XB---?-MBMT-M?XM?-M--M?B--MBM-|?oXoXB--ToXo-BoMoBBXEEo?-M-EBB-ET|-oEXE?X-?-XXo|XXXX-?-XBXBMBTo-BEM-?BB?XX----?X------MMMoBXX-X-|--B-EBoEBMT---B-f
-???|o?-XX--B---XXE?X-EBX-|M-??X--M-E-oXBBXEM-B-BT-?XXXX--oo-XBX-E?B-XX-o-M-MB--BBXEE-MoM--??-XME-----XX-X?--B-EMoBo-o-XoXEB-?-X--?MMXX-EBX?-M?B-X-----?------MB--Eo-M-MM?Boo--o-XBX---BX-M---XoX?|XXX-f
m-M-BX?-?oX-oB-B-XMBB-E-M-TEM-BoBEBBX-?-MM-?MXX--o??XoX-?X-?M?TTo--BB-?----B-X-oX-B-o-o--o?-?BoMT-BE-X-BBBXMX-MBB-XX?o???---oXM-M-o??M--B---X?oBoXXMB?T-XX|XB-X|T--XoX|---XM-?EMBBBEMXXoXoToEXBoBB--XBBX
XXXXXXX--XXXXXXXXXXX--XXXXX--X-XXX-X-X-X-X-XXX-XX-XX-XXXX-XXXXXXXXXX-XXXXXXXXXX-XX-X-XXXX--XXXXX----X-X-XXXX--XX-XXXXXXXXXX-XX-XXXXXXX-XXXX-XX--XX--XX-X--XXXXX-XXXXXXX-XX-XXXXXX-XXXXXXX--XX-XXXXXXXX-X
