-?XTMB---T-B-X-TE?-E-?BTBTT-|-o--oTE-TXBX??-?-?ToBT--T----T-?|TT-ooXoT?XME-TTo-TX-o|--MToM-T?-X-o-oTBoM-ToX-X--?o?-oo----?o|--X--X?o--XEo?To--?TTTM|--T?T|?-MTT-TX?-||XTXX-oBEXo-oE?o|-X--T-T-TBXX-?|T?-
---Xo----T-MoT-BoE--X-XE-MM-T?T-T?--ToXT-oTo----T-X?--ooX?ET-MMMX-TX-oB?|X|T-oBTX-o-ooT--BTXTBTEBX--?-o-TMBB---X-M-T-o--T--X--?X-XE-?TE?-|X----oMBT----|--BXToTo-?TTXX---?MM|T-B|-T--XB--BoTT---oMBEEB--
-T-XoM--Bo-TTX---XBo--T-X--TM-X-ET-BBXoT------X-X-|oT-TT-T-oT--|?---XB?E-oo-B-BTM-B-?oXTBoT-?X--BTMEBooo-EX-oo?XM-|o??T--?|E--o-B-T-T-?T?-XT--X-Xo-T--MTM|TXETX-MoTM--BT--BTTM-Eo?--|oTTB----XE-XETT-X--
-XB?XMoT?TTTT-TXMEX-T-oXXo-TMTT---?-TT-XoB-Xo-T-Eo?MTooTEX-XXXEo-|T-TEo-TTTEoo-XE-TME--E--T--?----?--Mo-B--XM-?MEMXBB-|X-oM-X??B?-E---XMXEBE-TTM-??TXo-T--|-XX?ET-TTTT-E---T-To-TTo--?T-E-|---o-T---TTB-
-BTE-?Mo--TX-TBo----?-M-XBTTTT-Bo?TT-T--o---ooT-?-XBToo---TT---B--ToTEXXEo-MTB--X--ToXXoXT-ooXTEX-T--T--TT?T-Bo-M---?BE-BM-?M--ET--BBE-XE--B-X-X--T--M-T-To-oX--oXE?--B--TME--||TT---X?-?XoEBT-E-ToooE--
--?XT---T-ooBToBTXBXTTXTT?-o-o--ooMXE--TX-oM-oTX?oXB---T-oo----X--o?-BX--BT|?|oBo-TX?oXMTMBB--B?M?--E--oo-T-EET?T-To--?oTXEMEE?-BX|BX-?X-TTM-M--B-TT-TEM-?ToXTB--T?--X-TTTTM-o-B-To-TTEXo-TX-EX-?o-TTXT-
--T-ToT-TBX?-TME--T?TTXBTT-?oMTMBT|o|oo--|o--X------M|ET-T-o--X-?-E-TX---|MT--X?T?Mo---B-TM-o??-oBooTXMoT-TEBXTE?-T----X-oXT---TX?M-TXMM-|oMXTTXoBTET-TTX--B-X-Moo-T--B--T-XToBTXT-oXE--|----??BT-X---T-
-T?-|-E-BT-B---T-TBXBo----?---TTo-BEB-B--M-Xoo---XTXETE-o-T?ToBo-To-E-B-?o-E--T-oX?oXoTo-?-?-o-MBEB--B----|-oXT-XT----TB-?X-T-MBXTEXXM-B-E-M----B--TM-o--T?---T-oT?ETT|T-MTE|TE-XT?|EMTB-?--EXMT--o--EMv
-|M-XT--TXXBoTXX?--o-T--T--B--T-TM-?E-oooT--oTX|B?o--Bo-|TB|T-ETBBEo-oo-E?XTTX-?T--M---oX-TT?TBX?TX-T--TMoX-?-E|ETo-M??X?TE?---BoTB-oXoB-XX-BBE-oB-oBTT-?ooTTM?-T-E---T|T|XX|--M-XXTo-E?Mo-X|-B--EX?T-|f
---|T?X---T--XX---X-TBT-ETTEMooT-E--XT----oT?X------M?o-X-MToX-T-T--T-o--TTBX?BT-TEXo-TX-X--E-TB-T?-T-To-BT-T-o?--T-XM-ETB?-E---E-oT?--|BM-o--Mo-XB--T--o-X---BX--o--To|X--?T-E?TEo-o?XB?-TMTT-o-T----Tf
--|-X?T-X-o-T-B-TB-B-TT--BXoXX-E-T-MB---o|-o-TT-??oT|--?oBMMoXXETX-|o-o?M--B?-XTB-TX-TTTM|?oB---o-BTTT--EB|EEo|-?o|-EM-XX-To-M--TXXo-?--TT-BEo-E-oB--XTT-B--oXT--EX--oXoX--TE-X?M?B-M-B|T-?M--T----X-B-f
-TX-?-X-X-X-TB?|-XMT-----B---X--TB?-BTE-M?----BT-TE---BT|?B-XoTo-|?--X-o--TTEo?oM-XX-|-MB-TEEBXTBB-o-?-T--oTTTo?-E?-T-TB-oB-X-To-ToTTT-o--TBoBE?M-XB-To-oToTT--EXXTET--X-o--X?XTT-oT|TXET--TTXX||-XT-?|f
----M??|MBX-B??X--ooEX--BXB?TMo-BX?XMX-MMB-M?B?BX?-Xo-MB-EM?E-oEX?E-------X?o-?-Bo?--EMMBT--X?XoXX-BB-M|M-BBEBB-XXM--M?--o-MEBX??-XB-BoBEX-X-XB-XEXE-BMBX--BXM-?MX-XBBo-X--BTEB?EBMooXoM--B?oBMBB?B--XXf
-MooEo-ooEMBB?METBEXBXB?X----o--ooBMBXMEBEX-X-??E---BX--MoEoMX-E|M-XMXoB?Eo---?TXM?-XMBB-B--BEMXEB-B-BB-o---T--XMo-M-oBM?o|--XXX---XoM-X--oBX--E?o--?BEBo|XEXXX------?-??-XE-M?E--|--X-B--M-BX-??B-??X-f
mX?-XX?oX-?-XT?TMB-??-M|-B-BX-o-Xo-EB-o?-B--oMo?X|XoBBoM?X--oo|?-BMo-o--B-B-|B--XX--o-?-XM|B----BoXE---Xo--?E?-TBB-?|XX--oX?BoXXEX--E?---B--Eo?B-BBo-B-BX?-BXo--?X-BBBB?M?-----?-BMBTXEXoBXo-MXMMM---o-X
XXXXXXXXXXXXXXX-XXXX--XX-XXXXXXXXXXXXX-XX-XXX-X--XXXX-XXXXX-XXXX-XXXXX-XXX-XXXXXXXXXXXXXXXX-XXXXXX-XXXXXXX---X-X-XXXXX-XXXXXX-X-XXXX-X-XXX-XXXXXX-XX-XX-X-X-XXX-XXXXXXXXXXXXXX-XXX---XXXXXXXXXXXXXXX-XXX
