---------------------X-X------o--------X--o-----X----------------M-----X-------?---------X-o--------------------M-----------X------------------?-----------------?---o----------X----X-------------?--o-
-------------X------X-------o-o-------Xo-o-X----------------------M-?Xo---E-----------Xo------X----o-----------B----?-----o----X--------------------X-o-----------o-------E----E-------?--------M--X----
--o------BX-----EX---------------o------------M--------?-E---------------B-------X-----------------------E--------------------------X--------X---X----------X---------------o-----------?o?----EM-------
--------------------?-----------------M------------------X-------B-XX--------M--------------------------------------X-------B---------------XX---X-----?-------?X----X--E--o----------------------------
---E----------M------------------?---?-o---B---o-------?-----o------------o-----X----o?--o----------B----X?-B-----------------E-------------E--------------------------o----------------------X--X------
-B-B--B---X-E--------?----?B-------o----------o--X-B-----------M--E-------------B?---------B--------------------------------------------MB--------X-E------------X------------------MM--B-------B--E----
----B--B---E--?----------?o------------X------E-?----------------BX-------M----X---E--------------------------------------M--------------B-------X-------E--X---------------Xo-Bo---------------?-------
--X---------------------------E-----------X-M-------E-------------B--BM--------------------------------------------------B--------M-X---------X-----------X---X-X-------M---------------?-X-o----------v
-E-----o---------o--------?-o-----B-------B--------------------------------------------o-----o-----o-------B---X---------------?-----X-o------?-----------?---BE-o-X-------B---X---X----------o--------f
------X-------------o----M-------------------o----?------o-----------------E-----------X------o------------X-E--------M--E--------------------o---------X-----?-?----X-EEX----------E--X---------------f
-----------?----B---E---?o-----------------B---------------B-----o-X------X---E--o--X---------------E--------------E------o-----------------o---------------------Xo----------X----X------oo----X-----Xf
--------M-X---o-----------X------X---------------oMo-----X-------------B--B------------X--------------------------------EB-------------M-----X---o----------------------------------------------X-X-X--f
---------oB-M-------BB--E---------------o----B-o---E-------BE---X-?--M----?---MX---?----------?----X-B---X-X----EX------?-----BX--X-o------X---?---oE---------?--M-M---E--XBB--B---oB-?-o-o----M-B---oXf
------?---TT------E-----EE----E---T-----------M-T-?-E--------X---T--M-T-------T-------M------?-----T-E--------X--------------------------T-X---Bo---o-------?---o------------M-----TE----T-----oX------f
m-----E-oE||---------B-E--?T------|M-ETM----?---|---|----E-B-----|?-?-|---o---E--X--?--o------E---E|-?-----------?------?TT-------E------|-----E---------------TT------T-------oB--|---T--TET------TTE-X
XXXXX-XXXXXXXXXXXXX-XX-XX-XXX-X-XXXX-XXXX-XXXXXXXXXXX-XX-X-XX--X-XXXXXXX-XXXXXXX-X-XXXXX---XXXX---XXXX--XXXXXXXXXX-XXXX-XXX-X-XXXXX--X--XX-XXXXXXXXXX-XXXXX-X---XXXX-XXXXXXXXXXXX---XXXXXXXXXXXXXX-XXX-X
