---ET-------?------B------Mo-----------o-E--MB--BXT--------------T--o-E-EB------TB-MT-M-----T-------?--o-TT------------X?T-XT--------|----T--|T-MT---------X-?--?oT-T-M--M---T--?---------T-----ET------
----?-------------o--B------------oX------------Eo--?--|---T----T---------X-----X---X-----X---------------|-----X---o--oo------TM--TTo--Mo?--o-------B--T-o----o-To-T-----o----------------M--MT-B-?T-|-
---BT--B-----T-T-B-TXo-|------?---X?----------E-----o-----|--B-XB----|---B------X-T---TB--M-----------E-o----------B?-X----------------?-------T--E---------XB----?-|------T-----M-------B----------E-?-
-|X-----?-oEE--T-TT-----o--T|--o--X?--o-----M------?----------T-----?--T---T-M-T--------------------|--X-------B-------E----To----------T-T--------|----B-M-T---E--X-----M-------o------TT--T-----------
----------?-B--E--E---oE-E-----M-T-T-MTT-o--------?-T-----T-X---X------B??------oX?--M------?----M-?-o---o-----|---T--------T-------------------B-BTX-EX------X?---o--XB--E--B----X---B--o----?TX-|--|T-
-|--?-------ET-X-T----------------------------B-oE-XE--T-BM---------X|--T-BT-|--E---M----X-X---B--Bo------X----T---M-T----T--X---BX---?|------o?M?-X-M-?-B-----E?o---XE----E-T--?---o----B---T-T------B-
--o-X---------E----To--?o-o|-o------T----X---?--T-T---B-------X-----M-----B?-M--------------MB------X-o-T------E-o---T---E---o--------T---M------o---T-----X-T--?--?o---X--T----T--X---oMoE|--o----T----
--X---|----?-To-o--X-X?-------X------B----?T-B----X-X------B----B---MT-------M-oT----XE-?-T----M---X-?--oT-Bo--TM--|-X-T---XTE-B--T-X--T----?-?----------B---TT-----X---ooX-----------?----------------v
--o-----B-?-o----------B-MTo----T-o--BX-T---o---------o?----M---X---B------------MX-X-----|M---oX-o-?-----|-------TT-ooT-X---oX-|---XB--o-o-------o---XETT--------------X---BoX-XT-------T----?TT------f
-E----EB--------|-------o---T--------------|BX----T---?--TT-----T--o--T---??---METTTT-|T---?T-?---oo---ooMX---BTo--|----------o-o---T--o---TBX--X-----T-----T-T----X------M------TX--XT---------|o?T-X-f
--o---oT-T--?---X--T---T----BE-------|--|-----T|E------------X---X--X--E-XX---TB---?T----o-----M---?----------------X--------T--o-X--X|T----|oX-X-TX-----T---X|---------BT--T--X|o--?-------------X-o--f
-o--------B----B-----TB---------------|-T---X------XB--o--BX---XTT---?-M--M--B?To-?--?--X----B?X-B-T-----ME----XT--------EEoT-oX-T-----------o-T-----E----B-?M--o--------T-T------E-XT---Xo----XB--o--Ef
-B-X?-XoB-XBM-oo?B??MBBX?oXTTo?X-XXBXEB-Bo?MBBoM-EE---BB-oM?--B??Bo-?B-?XTXBBo-XXBoo?EB-oXB--EMM-E-XoM?BMX?M-ooBB-BB???-?XXM-X-X|-o---o--EBXMXB-MM-XBMBBX-ooXXoX-XoXooX-B?o-X?B?--?T-X--XX-?oEBoEX???BBf
-BM-XB-EX-?B----XXMT--EM-?B|--oBMo?---EEEX?M---M-B-?--o--X-Bo?EoMo?EBBX?---MTXBB?-B??-B--B--?X---M?BoM-??oX?oB??--oM-BoE?BB?XoX-MXM-BMBMB-oBX?--B-o--o-oXoXXBBE-Xo--oo-o---oB?-X--B-X?XX-TE---BMB-M--B-f
mB|T-MBBXT-B?BBB---E-?E-?-B?BoB?oo-X-E|-MBoE?-BX|BXEoME?Mo-BT-|-X-M?--X???--|B---B-oBX|-?-BXXB-X-?--Xo-TXo--BM--XTB?M-XBX-MXBXE--oE?Bo-??X--oMoBBBXX?TXMooX-X-MM-EMBE?Xo-XEoB-X?TXB-M?X--BB|XMo--B-BMXoX
XXXXXXXX-XXXX-XXXX-XXXXXXXXXX--X--XXX-XXXXXXXXXXXXXXXXXXXXXX-XX-XX--XXXXX-XX-XXXXXXXXXXXXX-XXXXXXX-XXX-XXXXXXXXXXXXXXXXXXXXXXXX-XXXXXXX-XXX-XXXXXXXXXXXXXXXXXX-XXX-XXXXXX-XXXXX-XXXX-XX--XXXX-XXXXXX-X-X
