--Xo-Xo-XXBX--TToXMTXTM-?TT-oM-o-MB-oT--|oo--T-T?o?-?-oX-M?X?oM-TM-XB-BT-XTBBMT?-XE|?EX-oMTT-TE-Mo??--|?--?-T-TTXTXTETT-oX?-E-To|E-EXTM-|-M|--XTEoT-?-oME---?-BX-E-oTET?--o-TX---BM?TB?-|-T-|-oTBo-|EE--
--MooB--MT-EX-----?o-||ooBX-BT-E?--oEM--X-?T-T-o|oXX?E-MTTBTXTTEX?E--BX-B-ToXM-o-E---T--EoT-TX-EX---?-EX-TBT?o-M-T?TTM?EX-X-T-o|?--M-BXE--B--T?BB--B-ETo-E--oT-M-B-?To--o-T-X-T-E--E-T-BXoTXTX--ToTT--X-
-TB-M--o|BX--XXo-TTB-MX--TXX---o-o-TTT-o?-T?MT-M?-TE-ETT?-oo|oo-M-?-?X-TMMXBX?X-|?ME|-XE-?BB---?TT-MTo|---M?X-o-TX?T---?-o-T-?--M-oToT-XEMToTToE---MTTX--o-TXoBoToo-XoTTB-o---|TM-T-EEo-X-EX-|-X|?ToXEM-
-|X-B-M--XX-E-EM-TEMo?--?-?TXMX-T-TXM-M-TT-X-XX|?-XM--B?TB-TBM-?oET-|T-o?XMBMTX-XT-?-ToBB--oTM--ooTBT-o-?E-XT-?-XXB-T??To--oBoo-----|o-T--XToo-T-|TTT---E--E|?--B--T?---||XXTTT-o-oXXoBTToTo--B--?T--TE-
--BBTMXo?XXTM-o-oBo--TXT---?-ME-o-XEToE?Mo-o--o--B-EM--?-XToTEXTMB-Xo-MXTXTooX-XoT-XT-X?BXTT-MM-ETo-E--X---M-?TTM-T-EXX?|T-Xo-?-ETT-To-|-X-oB---TXXTT--TTTBTB-B--T?-X?MTXT-MXo--E-E|EBTX----B-|ME-o-oTT-
-o-|oTX?TTTo?--E?-o|-BT?-o-?TT-MTE--??oT--Xo-ToT-MBXT-|--MBXT----M-XM-E--BMB-TXXTB---X-o--B---X?o--?--XB-BBTBETE?TToBT?Eo--?BXo?-E?---M--B?E-EoT-B----TT--XoXM?BM--?T--TT-ToX|-o--TXT|--X|T-MT-B-X--T---
-?o--T-T-o-M-----TM-T----BTo-TM-T-E-X--oTE?o-?-T?|-X--ooT-o-ooXT-o-XMBTTXB--T-Xo--?BXTX-??TTETXTMX----oT-ToT-BBTTT--oT--X|--o-ET-|--M-XEMXEBT----TooX?-BXo--o?--|oB??--T-B---ETM-X--TMoETTB-T-TM--EX?-?-
--XT|M-TTE---E-o?MoooTXMT-X--oM-XooX?Xo---T-M---?-?-T-M-T-TBB-?XE-Boo--TXE--?EM-TXB-o---||-|XMTB?-oMBTB|?--XB?XoXB?-T---oB-B-TEo-BT?Bo---|TMoEX-BXMBT-EE---XTMXTo--T?To-T-B?E-T-?-M---X-X-ToE--?BBM-TT-v
---BToX?XE--E--E?XT--??oT---|-T-BBTXT??--B??MXTToBXT--T-oooB?EEE-TX||XTB-B--|-oo---?T-To-XTTXT-EoBXTM--T-MTMT-E-XT--o-o-XoTXo|BoM-?TBXM---oT?B-MT-T-|-B-TX|X-T---|B-B?-?-XEBo--B-o-B-?BoB?T-MMXTTT|T?B-f
-M-TXoEBTo-o-oEMo-T-M-E--||X-oEo-T----o--oBToT-XBTT?ooTEoTooo-o???|-XM---o--|oEXE?T--XE-o-oET|ToXT|?XEEXX?--T---o-XBEo-?XTTT-oXB-XX--X----X-BT-TB|Mo?ET-TMXToE?oB-?X-o-?--X-?-T--BX?--MBTXoToXEoB-TT-XXf
---?-M?-X-??EB?|MB--X?T----oT-|M-B?M-?o-Mo-XT?T-T---?-oo--Too|?T?XTT-To-|E-XT?MMX-TEM|B-XMB-BE---T|EMT?T-----M---T--|?E--o-TTo|?X-?XB--B--T-oB?-E?B-oo?-oMTTM-ooBEooT-BXB-EBB--X-Bo---T|--MBT-XX?|--ooTf
-----TTT-E--|-T-TXToMM?-X--o|?ET--?BT?--XTBoTXB-?o-EoX-BMM-TT-T---To-E---TTEM-E---o-?T-o-----X|TB|B---B---o----|BX-?-T--X-XXXMoooTXXXX-oMET-BXT-T-M---?----M--?---TTE-oE--B-T|E-X-?--TX?-oXooBBo--EEBBEf
-??BMXM-o?-X-X-XoX?MXooE-EX---X??oE--?MXM----?-o-X-TMM-oX?-X--BM-E-Bo---X-o-oBo--?-B-B--o?--XX?-BX---EB-o-oMB|X|--oXo-B-?MMXB?-E---BX--?-o--X---E-oMMo?-Eo-X-E---XT-B--BBMBMXEBX--B--MB-Bo-oE-?-XMB-oX?f
-BT|B-M-o-o--oB?B-B-ETBXB|?-MM?BETMXXBXXXB--X?TXX--?B---XBXXX--XB-E--?-----B-B-EoBoE-|o--oB-X-BB-XMoB---BXB-BXoBX-o-X-B-?Bo-BM---B??XB--XB-?-BBE-EMMXE----?X-X-MXo-??--?-??oEo-?---X--EX?XXXXTMB?o|ooXEf
mXo--M--oo--Bo--Mo-X-E-X--?-X---BE---X-XEXTEB?XBB?T-?--BXMMX-?BEB-oE?o-M?B-MB-M---oXB-?XXB?o---?ETXX---o---o-XBX-MB?ooM?XBXX-?EoBX-MX|--??BXBBoMEBT-?-T--oXX??-B??XB-??X-o??--X|XM-X-XEB?T--EBX-EBX|-B-X
XX-X-XXXXXX-XXXXXXXXX-XXXX-X-XXXXX--XXX-XXXXXX-XX-X--XX-XXXX-XXXXXXXXXXX-XXX-XXXXX-XXXXXXXXX-XXX-XXXXXX-XX-XXXXXXX--X-XXXXX-XXX-XXXXXXX---XXXXXXX-XXXX--X--XX-XX-X-X-XXXXXXXXXXXXXXXXXXX---XXXXXXXX-X-XX
