--?--?|B?-MT?Mo--?TB-|E?o--XoE-oTTM-----XXTT-XBB-?B|XT-XM|ETTT-XTBo-oX-TXM-?-E-T-XBBT-BXTE-TEoMXT-|----XXT-X?XMEMX-T|?BB-?--B?-XT-oT---ETXTX-X-o-XBX?o-?oB-o---BTB--XBB--BT-BM?-?-EM-TM?TB--BoT?-TM-Bo--
---?-oXXTo-Xo--T-X-T--?BT?BX?XX-o--EXMToT?-?---MBXoTB--?-T-T|BTX|TXXBM---T-B|M--E?E--o?-ToEM-Eo--T-oXMM--B---o??-TX-XX-|EET-?oBTX-o--oTT-o--ToBXBTMoM--o?|TooTTX----ooEEoT?To-oT-B--XToXT-MooBTo-MET-BT-
-------oX--EXTM-BB?XXoTB---TX?TX--ooToTTT-TMXE-T|-|X|-ToT-M-|o?XM|--XT-|X--XBXoBoo-??T--TEX-------?BoE|oXB?BT-M-MBX-XoTo-?TT-|T--E-T---BTTTX-T?-?Too?-B-MMT---T-T|-oT-TB?---BX-?-To--TB-XX--E---T-MoM---
-E-o--TEMX-|-?E?-oo-oM-T-BT-o-To--o-M-|-?XT|TTT??E--BM---T--X-TTETBXXE-BT|TME-EXTo-MTXTBX-T-TTX---TXX--X|-M---T-|XB|---T-T?|X-TTTT-?M-X?ET?M-o-|MMB---o--B?oT--X-?-E--X-|TT-T|T-?-TMoTB|?B-X|-EoB--?BM?-
-T-T-T-E-X|--ooE-Bo--T-E-ToX--X-T---|?MTMEX|-oT-ETTT|--|X--T|T-oX---EXToBo-T-ToT?M-?-|--?X?TT--E|B--T---?X||?T|T??B--X----TME-oMo-o--TXM----?Bo---T-E|T-TMM-EMBT|EBTTEET---o-MMX-MX-?-X-o-XXX--?---XBX--
-X?-X-X-MoT|B-----oX-TM-o?oMoE-X--ToooT-T-|TTX-TTTT-M?-TTXT--?-o-B-?-XTo?o--BX-B-T--BX|TBTBTBTT-T-MXTTT-TTXX-EBM-T-|T-XET-EMX-|X-T|o-B|E--?E|M|M|oT--TTXB-TT-?MBTX-TT-||T-|X-M-oT-o-XTT|BXM--B--T|-Bo?T-
---X-ToXXT?T?ooo-B-ME--T?T?o-B--oBT|-E-BTTMoETT-?To-X?|-|?o----X|TE---o-XM?EEM--Bo-TB-TETEME|---|-E-o--?EM-T----oXoXoE-X----TT|-?T?-?BoXT----oBBTEXoXT-|-TT-oETo-T-E--|-E--EoXo-oM--X--XTX-T-BXMTM-XoET-
-B-X-MTE?T?-X|-??T---|?-|----BT-ToX----M?XB?X-TTX-o---BTTX-oT-XEXBo--?MX-o-oT---?-T-B--T--?MoMT---T-XM----XXT--BXXT?XT--To--?-oToTT-o?--TB-oo--TT---X-To--M---EoTB|---BTT-o---M-----TMXX?-E|T---TM--TEMv
-?B-T-oooo-TXEB-TX-TTTT-?TToT-|-TB-TBE--EEMM-?B-B-M|--?B--X|-?T--TX?MX-T-oE--?-XXX--oX-|T?T-?ETEXEETMXT------o-|XMBM?TTTEET-B?T?M--X?X?-X--X-BE?MB--MT?TTT?XoB-X?|MT|?BT-XEXE-TTT-X?--?TT-E-M---T?|TE--f
-T-T--B--ET-ToE-MoMoT-ME---TXoET?o-XMT---?XoT-|oB|E----XTTToX?T-MXEoo-XBEMEB--oTX-|oB-----|-T|----|M-MXo-T-X-EToB--BoT-TE-TT-oX?E--EM--To-o-MX--BT-?E----T--T--oMM-X-o?X--TT-T-X-ooToMTBT-XoBTT--TX-o-?f
-?XTMX?XX?T-T-X-o-XXE-T-oBo--B?o?-MM-TX----X-T|X---|X?oB---X-T-T-TToBEoME?o-BTEE--oX-X|XXMoB-oB----|-XoEM---XET-T-X-??--XX?-X-B-BToXTX-BoB?TTB--Eo?-BM-X-XooX-|BETB-To--?XX-B-?-?B-X-EET-oB--Bo-TTo?oT-f
-o---?--TT|TBBT-TT??-oTXT--TTBM-TX-XoT-oT?---oTB-TB-MTBoTMTX-TooBXM??--oM--TEXTB|-T-XT-X-TTTTBoX---BTE-T-XTB--T?o?o|E--XoT-?o--|oo|X---X-TE-TT--o?B-----T-BXBo-oX-TME-BM?X-X--TBoM?XXTMB-?-?X-|T-|BT|TBf
-MB-BB-?o--XX?o-o-?B-o---M--Eo|B?XXEXBX-?-XE-MB-o??-o-X-MT-??B-oE-EBXX--X-?-EXXBB---X--B--|??B-oM-MXX-EX?XX-BE-MXEo-?MB-?|-B?-Bo--BMo-BX|BTEM-Bo-o-BoXXoEXEo--XXB-Bo?---X-X-EX-B-BoB?M-?---oE-MBooXE-B-f
-o--o---MXX--BE?M--XXo-?Xo--o-XX--BX?-??M|X-B?---X--XX-MB?--X-B-?-o--X-XEMo-BB-B-XB-?BM-BXB-XoX-Eoo-MXM-|M-BX-XX??-B?X-?-MB-?EX--o?-B--B-EXE-?-?-MMo---E-X---X-?-XMBE|T--MXoX--?-oB?-EXB?XBB?XMoBX?-EXEf
m-E---oo--?EoX-BBXM?B--BB--E?M|Bo-XBMB?MBBB--X?o-?BM-X---oM-E-?-E?BEo-X-M-X?M-|BoB-?o?oB-X--E--MB???B?BX---oX--B?BE?-oT?BXTMM-oXo--BXBXooB-MB-B-B-M?Mo--XBXMEBooE--B-?XM-XMB-o-B?MB--XX--Mo?M--?X-BMoo-X
XXXXXXXXXXXX--XXXXXXXXXXXX-X-X-X-XX-XXXXXXXXXXXX-----XX-XXX-X-XXXX-XXXXXXXX-XXXXXXXXXXXXXXXXXX-XXXXXXXXXXXX-XX-XXXX--XXXXX-X-XX-XX-XXXXX-X--X-X--XXXX-XXXX-XXXXXXX-XXXXXXXXXXXXXXXXX-XXXXX--X-X-XXXXXXXX
