--X--------E-----------??---o-----MB-----------------o----X--B------BB-----------E-E---X--B--------------------o-----X-------------------E----BB------B---XB--------------------M-----------M-----------
--------?B----o-o-E-----------------o----E-o--------o--------oM--------B----------------o--------------------X---------o--X-o-------------X---------XX---------X----------Bo--MoX---------E---M---------
-o-------------------------------------X-----------------X-----------?o------Bo-B-------------------MB-X------X-------------------------X-------E------X-------E----E----------------------X----?-o--?--
--?--X?--E-----XX--E---------------?o---------o--------M----------------------------X---o---------o------X----o---------------------------?----------B------------E-X----o-------?-o---B--M-------------
------------X----?-------M-----M----B---------------------X------------------------MX----------?-------------------B--?-oB------------E---??--XE-----------oB-----B-X-----------o----o-----?----------?-
-----o-------X-------------M--X---------------E-----X---X----------o------M-X------------B--------X--MM-----------------o-?--o--E-----o---B--BX---o-M------E------X---o-----?---Xo---------------X-o----
-------------X--------M-B-----o--?--------M----------o-X----B-----B------o--M-----M?-M----o----oB-B--oX-------?------------------------------------------o-X-------------------o------------------X-o---
-E---------o--X--o----------------?-----------------------?X----M----------------------------MMo-B-------------------?----o---X---------o---?-o---------o---------o--------B-------------------------?-v
----MEB-----------------------M----?---------M----------------M--X---o------M----------X-------------B------MB-----E-----------X-oo---M---o------------------o---------------------o--?----------------f
-------oB-----------o--------X------oB-B----------o-------------------------E----------o-----------------Xo--B----M---X-B--------?-o---o-B--B-------B--------------------------o----o---------o---M----f
--B--o------o----?--X-----XE-------M---------o-B------?-X--M--o--------M----M-B-----oo-------X---?-----o------B-XB--o------------------X-------------------------o-?------E-------------------------E--f
------B------?---------------------M-------X-------------BXM------------------M-----B------M-------X-----?--------B---------------------X?-?----M------------------o-----o?---------o------------------f
-------T--B--o|X--?--T----TBBT----?---T--TT----T-E-?-T-B?-|-B-----B------X--XT-X----EXXoX---X-X--X-T?-MT-B-B-B---T-To-o-M-T-o-ME--?-?|oTT-|XToTT--T--B----TB--TBXM?-|B-X---ToXX-TB-?-XX--?EBB-------XEof
------?|o-oooT-o-XE--X--M---T?---MT---oEEM---------BT-T----B--XX?-X---o---?--T-X--B-----TTB--TT--B--ME--?TB?-T----M--XTo-X--B---To--TB---?X----Xo?XE-----BT--T--o-ToTT---B?-XB-----BoME-------X-oB--?XBf
m-----X-----XB----o--TX--B--T----BM-o-XToE--MX-o-?-MX-----XTBB---TMETM-MB--EB-o----B----T---o--T-M----------??-----B-T---BXXo--M------B?-o-X--To-?--o---M?-T------B?-E-o-?|M--B--T--o-T---T---o--o-X---X
XXXXXXXXXX--X-XXX-X-X-X-XXXX-X-XXXXXXXX-XXX-XX-XXXXXXXXXXXX-XXXXXXXXXXX-XXXXXXX-XXXX-XXXXX-XXXXXXXXXXXX--XXXX--XXX-XXXXXXX-XX-X-XXXXXXXXXXXXXX-XXX--XXXXXXXXXXX-X-XXXXXX-XXX-X-XXXX-XX-XXXX-XX-XX-XXXXXX
