---XX---o-----XM--T---BE--o-o-M-B------o--T---?-|M-T------?M----oBT?-----BE-B-B?-TEE------------E---X-B---?EMo----M------T--B-Bo-E--E-----o?-o----oTB-B---T?-------|------M------B|---E?|---T--o----X---
-|o----Bo------X--|T--T--?EM------T--X----?M-B------E---oX---------------------E|---MT--?-BE-?---T--|---o--B-----M-|oE---M--?--ME?----MM|-T--E--T---X--------?---MEBX--|--------|-E-E-T---------o--X----
--?X-MT-o?--M-Mo-E|---B-M-B-----|---o---X--X--TBM-X--E--ME-BX?-----X--ET----XTMo-X--X|--?--------TB-|---M----------|-E-B-|------?----?----X-BT|-M----o-|E----------E-T-|E--B--TM|--M-----------EEE------
--B-MME--oEoT--B---o--M--------|?---To-o?--o---B?E-X--E---E----T?T--o--EBX--|--M---o|--?---ETXX|--?|-----E------oTX-o-----|XTE--?--XEo-E---oT---------B---E--M--MB--?--------?--BX-|--Eo-ME?-EB-MX--BX|-
----B-|------|--E-X----?---X------X-?TBE----BoTE?--o-------T----?-------?--oB--?-oo-----X??-BEB---|o|---MT-----T---??-X-----?o-o---oB-----M----|---X----E|X?-o|T---B|T-|--o-E--o-----|-?E---X----TE---|-
------M---X-----||B-TX-------X----X-|--MB--E--T-------M---|--oT----M---------?----?XT-T-o--??EX---X-EB|-?---------XM-BTMBo-----B|??---B---B---M-o-X|M-?---T--XoT--MMT-----EXBX--|--|-X?B---?T-E-?-------
-TEo?---?----MTo-------T-X-XB--TXoT--oBo--oT---?--E-?MEX-X-----|-MX-------X---o--|---B--o-------|-B----X-o?--------o--?T-------|MoB-B-oM-?M-X-o--------|M--|M-|------o---BM--X-----o--X-M-------T-M-B---
--To-X-BM--BT--X----XXM---------?----BM----M-M--X-M----|-----T-E-MoXB---E|--E-X---B-----Eo?-M|B--|--M---XX-----X-BB---Mo|M-T-----To-X||?-X--B?-X------?-------M----To---o?o----B-TM-E-ME-M---|M-?------v
-----B-T----?-EBB--|--?-?-o-B--o--|-oX----??---------o-T-B----E---X---o-M---------MMEX----E-BMB----E--E-MX------T---T|--?-oB|-----X-----Bo-X--|----M|-M--|MM|-----o?-To-------X?EX----B--------M-------f
------o-----B--T--B-------M--MTT-M-E---MX-o------B|M-E--T-M-?B---T---X----oM------XM-?o-oT-Bo--|--------XT-------E-----E-------|-----?-||---o--o-T--XM-E-M?M-----X----X?--?-------?X--o----?X--XM------f
-oo-E----MME-EXE------?----E--M---T---?-o----|--M---|B--------X-|--E--o----T-------M-X-------M----E---X---|----M-X?--o-M--?----------?EM|----B----E----B----|MBEX?Xo--------?|E|---X-X?------|--EE-MB--f
-X|--------T-X-----X-?----X---|--MM|BT-TB-BTE----|------?X-o----E-XTX-----XB-M-----E-|MX---To---B--------?--E|-oE-M-----|------X?--X--B--B-?X?-M-----E-----X--X---XE---o--?-----B--|----BB---X------o-?f
----X-------|B?-oB?-T|X-EoT--M---M-----T-?TXo?--M?XBE--------o---??--B--TT-------E--E---o-M-?---E-T---M-E-|E--o-XB--XMT-o-E?--------T---EB---?---B-B-E-ME----EMT?B-E-M--T---E--X----o---oo---XE-o---X-Tf
-MXE??EX----TX-----TE----EM--o?---TX-o-----MX?X--XMMX-------------oM-----o--M|X----X--?|TB-B---E------BT------X--BB---BXXEo-|----EM---??--------o------T-B-M--M--?--Eo-oBE-T-BBE-----o-------?--MX----Tf
m-X-o-X|E--|----?T-X-E?----o--------T-----X-o---E--E----o-o?---B-|-?-------E-?--MX--X---BTM-oB---M-Xo-----------T-BT---oX-oX--------M-B-T----E------??------M--?---E----T|-X--M-M--------o--X--X--?BTEBX
XXXXXXXXXXXXXXXXXXXXXXXXXXXXXXXXXXXXXXXXXXXXXXXXXXXXXXXXXXXXXXXXXXXXXXXXXXXXXXXXXXXXXXXXXXXXXXXXXXXXXXXXXXXXXXXXXXXXXXXXXXXXXXXXXXXXXXXXXXXXXXXXXXXXXXXXXXXXXXXXXXXXXXXXXXXXXXXXXXXXXXXXXXXXXXXXXXXXXXXX
