----B---------o-----E----------o-----E------E---------E-X--XX----------M---B?--M---X---M------------??-----M??-----------------------------------X|B------B-----M-------??-|-----B------o--|M---ME---B--
-o----------Mo------------------X-B------M---------?-----MX-M----?B--T-M------o-M-----------B---X-|---?--------B|--------------EXEM-BMB---o--X-------------?B------------M--XB--?B-o--------------------
-----|--o|--To------X-------BMoB--X-o--?-BB--|-----?---------M-|-|----------------M-------o---M--M-?---B--B---T-----M------------?------X-----------MX--B--X--X---B----o-------------------|--M--o-o?---
--M-|-T----E-XB---------o---------?----?--X----------------------o---o----X---?--------?---?-X-?-------E------?-------??o-M---E-o-------?-------o----o---?----ME---------|------------X--E----?----?----
-----------?T------X------o----X--o--X----B----|--T------E---o---B-------------B--X----EB--------?|-----T--B----B--B-|-----------EB--?--X----------------o-----|----------------B-o-------------X--?----
----oE---?----B---B----?--?-X----B-B-----B-------|-B--M---|--------B---?B-------------o-o--o--o------B---?---B-----o-----B-o--X-E------?M-------?B------X----X----------o----E-X-----?-T--X-----o----?o-
-?---X?E|--XE-?-----M----o?--X-o-------oB----------o----XX---?XB---?-----E---?-------X------?M--T---|M-E-----E-T------------------o---M----o---X--o---XX----B--X|----X---------|---B----E-----------E-|-
-B-------M--E----------X--B---------------?-------B------------X--X---------?o--B--E-o---o-?--o---?--M--E-----?--X--?-E-BT------------------------B-------------------M-o--------E----?-T-------X|-----v
----X--BB-B-Bo--------X--?-X-B---------T----------------?-----E------?E----------|----X----o------------?X?---------X--E-------------X--------o-----ooX----X------T?M-o-------------------------------Bf
------XM--------TB------?--------------M-|----------o-E------X-X-------------X---------B--B----------------------------?----M--------E----?-----X--------B-oo-|-o---M------B---E---?------X-----------Bf
----M----o-o-----B-----------M-o----X-B---E---?--B?-------E-E------|---------------M---?-------?---B-o-------------M---------------------M--XBB--------X----Eo-----BM-E-----M----------------E-------M-f
-------B--o--------o---X------B--X----------o------|--X--?---------|------?X-------M--|?-----E-oo--------B-B-----M---E-----E-X---------------E-----------o-----TB----?-E-----?---------E--------?------f
-------------B-------E-M-To----T--B-T--X-----------------M--X---------------?o--BM--E-?---B------?-o-B--------------EM|B-E-?-B------B--------?-------o-X-------------XE-----o------X----o-X----B---o---f
----Xo-|--M-------B----o----T--E------------o-----M-|-XB-E---X--TT----o-------X-------X----XB--T---o----X-B---M-----?--------T-B----TB-------B--------------------------M---------E----B-----B-?--B----f
m---T----B-----------------?----B-----XM----------o-----TM-----------?-----------E-----------|-----|------o---------------------|-X----------X----?--?--M-----M--BE?--|--X-T--B---------------------?o-X
X-XXXXXXXXXXXXX-XXX-XXXXXXXXXXX---XXXX-XXX-XXXXXXXXX-XXXXXXXXXXXXX-XXXXXX-XX-XXXXXX-XXX-XX-XXXXXXXXX-XXXXX-XXXXXXXXXXXXXXXXX-XXXX-XXXXXX-XXXXXXXXXX-XXXXXXXXXXXXXXXXXXXXXXX-XXXXXXXXXXXXXXXXXXXXXXX-XX-X
