------------------------------------?-?-------------------------------------------------B-----B--------X----B----o-X---------------B-----------------------X--------------------------------o---o-B-----
-----X-?----------?-B---X--M----------------X--M--------------X--------o----------------------o--B--------------X--------------------o-M--------?----X--------?-X-----E-------------E--------------?-B--
--------B---------------------B---------------------------oM----------M----------o----------o-------------M---------E------------------X-------E--B-----XM----X-------------------------o-o----X--------
-oE--------------?-X--E-X---B-------X--X-----o--B-X--B-X----------o--------------B----------E------oX----o------X-----------E--------------------M---------------------M-X-----X-----X-----E------------
------------o-----------------X-----X-o-----------E--------------------------------------------------o-?----------?-----------B----------X------Mo------------------------------------------------o--X--
-------------------o----o--o-------M--?-o---X-------o----?-------------?----M----o---o---o---------------X------------------------X----X----------------B------------X------o--X---M----?----o----------
-E------o--E---X----M-o?-----------o------------X---X----------------------E------------------------------M-----o-------X--------------oo--X--M---B-------------------oX-------B-----------------?------
----------?-------------o--------B------------------------------?--------------------Eo--X---oB-----M-----?-----------------------Mo------------?--------B-------X--------------------B------------o---v
----B----------------------------M----------B------B---X---o----------------X--M-M--E-------o-------------------------------------B-X------------B-----X----E--------------------B--?--------------M---f
-------------------E--------------------------M----X--o-------X----X---E-X-----M?---------------------------B-------------------o------Bo----------------M----o----------o-XB-M--------o----X---X------f
--B----------------------------X-----------Bo--M----------B-----?-----X--M------------------------------------X-------------------?-----------------------?-----------B-o-----------B-------X----------f
-XX-oX------?--X---X---------------X-----------Mo-----?----E--------------X--------------M----M------?----E-------B-----------------X-----------X-----B--E---E-o-?-oE------M-X-----B-------------------f
-------oBXBX---o-M--------oB------------B---M--X--ooB--M--?B--o-E----------?------o--X-------E-------?o-B?XXB--o-oXM----E--------o-E-----o-o-------o-X----oX------------o-M----?-?--Xo?E----X-X-o-o----f
-----------T-----BX---------------------------B-E--T----------------T----T-X---TB-B----X---------T-------?E---M---M-------o----------?E-T?----?-T--------oT---E-----?-X----TB--E----X---E------T-------f
m-------EE--------------o-E----B----E-----TTo-|---E|T-|-----T-------|--o-|--?--|T---T---X---X---M|---EBB-X?E---E-----X--------o-------o?-XTE----|---------EE----B------ET--|--o-----E-B----E-|-----T---X
XXXXXX-XX-XXX--XX-XXXXXXX-XXX-XX-X-XX-XXX-XXXXXXX-XX-XXXXXX-X-X-X-XXX-XX-XXXX---XXX-XXXXXXX-XXX--X-XXXXXXXXXXXXXXXXXXX-XX-X-X-X-XXXXX-X-X--XX-XXXXXX--XXXXXXX-X-XX-XXXXXXXXXXXXX---XXXXXX-XXXXXXXX-XX--X
