----------------X-o-M-E--------------E-X----------M--------X-----B---X--X---------------?-------?----------------------?---------B-------?---------X--------oo-----X-------------?-----------------B-o--
-o-------------E----------X----o---------------o-------X?-------o------?------X-----BB----------------------X-----------M--------------------XB--B---B-----E------------------E------------B---------?--
------?------X-----?--------------X---?o-M------X-------o-----M----------------B--------MM---X---?----X----?---oX----B---------X---X-X-EE?-----------X?----------X-----X--------M----------Eo-----------
---?------X---------X--?---------?-----BX----oB---------------?---------------?-o----------------M--E--B-------------XX-Bo---B----o------o----X---X---------oX--X---------------o----B------E-----X-----
----------------oo----B-E---------------?---------------B-M----?-X?----------M---------------?--------X------------B-----------------------X---------o---------------------------X-----X--X--------X----
-----------X-----M--------------------------?----------------------------------X------------------------B---X-----------B--B-----E-Bo--?X--------------X----------B-----------o-------B---X---------X-M-
--B----o------E-?----------?---B---------M-X----M--?-------------X---X----T-M?-----X-------E--------------------?--------M-------o--------------X--X------X-B-E--X------o---?---o--E---------B-----o-?--
----B------------o-----------------?---B--X--M-XB?-M--o--------X-X----o---X----o--------?---------------E---X--------?----------o--------?-------------------------XM?-------X------o----------------X-v
-E-----------E-------B------------------------X--B--o--X----------B----o-o---XM-----------?X--o----------------------MX--??----X-----------------B-------X-------?-------o-M-----o-----X--E-----o-----Ef
-----------X--------------------E------------?------X-----------------------M-------------?------?-----o-----X---o----?-----------------E--------------o--o------oo--?-B------?---o-------E-------X----f
------X--------E?------X--X----E-----o-----X--------XX--X--------o---M---------------X--E---------------|------X--------X---B---E------M--------E--?----M-?M------?-----------X---o--------------------f
--X------|--------------------o---------Xo------------------?-------oX-ME-------------?----?---------?--|-X--------E--E------X------------X-E-BM--------E----B--------------------?---------X----|-----f
---------||B--o-X------T-o-TT--T----------?B?--?T--?--?M-X-T--EX-------B---|X-?-------o-------XM------MT|XM-TTo---------MB-BX---E--T-o----T---M-XMoX-T--M-E-----o-----B---o----BE--T|BT|--T-Xo--E|-T--Tf
----------|TT----------|---||X-|-------?---|----|--|BE--||o|--T--T-----E---|o-X|-------E--o---E--|E-E--||?--|TE----|E------X|--T?-E|o--Eo-|-----T-|-||---|-EE-||T-TT--|-BX-----?-|-||-||E-|E--|--|T||-Tf
m---------|||-E?--EX--T|o---||||?----M|B---|-M-----|-T--E|--E-|--|--|o-|-TBT|E-|EX|-------?|-------BT--||---||-E---|----E?--|-----||---E--||To-E|-E-|||-o-E----||-||E-|---|----E-|M||-||E-----|--||||o|X
XXXX-X-XXXXX-X-XXXXXXXX-XXXXXXXXXXXXXXXXXX--X---X-XX-XXXXXXXXX-XXXXXX-XXXX-XX--XXXXX-XX--XX-XXXXXXXXX--X-X-XXX-XXXXX-XXX--X-X-X-XXXXXX-X-X-XXX-XXXXX-XXXXXXXXXXXXXXXXXXXXXXXXXXXX-XXXXX-XXXXXXX-X-XXX-XX
