--TX-E-----oB--X-----?--B-----------T---B---o----X-----?---X--------------B---o-----------o----?---o?--------------M-B------------------Mo--------M---------X-o-----T--?-------T---------------?-E-o----
--------?--o---------------XXo-----E--o-|?-------M-X?M-----oo----X---B-X------o?-----M------------------B-----B--X--M-----X---?M----M---T--X-------M------------?---?-B----------|--M-E---E-------------
------------------o---B--------------X|----------B--------B-E---?-?-----------------X?---B---------|--X----------------------------BM----?---------------M-------B-----|-|XM---E----B-T-----------------
---?---B------B-------o-?--------?----?----Bo---M-o--X----B----M---------------o-E----------B---------X------X--|--------------X---------B--------M---------E------BE-------------E?---E-T--------------
--B--B---X--X---?-------------B-----------------?----------?o---X------------------------------X---X-----o----------E--B---?--------------------XEB-------X--------------------------?-oT--BX?M---------
----------M------B----B-----EB--M-E--------------------------------------?-o--|-X?---B----------------------------X-B-o---o----o-?----------------?B-------------------X-----?-------------M-----Xo-o---
-------------?------------------E--TB?-------------B-o-----B-----------M-----T-?---------o---BB-----X------E---B-E---o-o--------XX-------ME-o|-----?B-----?-X---T----o----------|B----E---B--------o----
--|--?--X-----E----------------------B-----Xoo--o-----?-X----T-----B----?------------B---------------B-------------------M------X-----?--------------E-------------X------|--------o----------B----E---v
--M|---------------?----M----------------M-o----E-X--M-o-?-M--------o-----?-----?-|------E------?---------X----o---B-------------X----------Xo----------X----------MX--o----E--M-------?Mo-------------f
--?-------T-o---M-------------o---B--X-------Bo-----------?M-------------o---T-------------------X--------?X--------------o-----X------B--B------------T---?--------B-BMX----E----X---------E----------f
---XB-----X-------X-------X---------B-X-B--------|-------?-T---------E----B-----------T--------B---B?--------------M-----X---o-----------?----X--M--|------------B---B----------o----?-X-------M---M-B-f
------?-------o-----oXo---------?-M-------------T-----------E---o------------E-----------------X--X-----X----T----------?X-o----T---------o------XX--------X--------------?--M---------?--?---MB-------f
-------------X----E---M-XX-------?--o---o-----X--?---?-----------T--X-----------------XX-X---X------BB---M----B--------?-?-XBX--------------o------o--E-?----X-MB--------------------------o--X----E---f
----BoM-?oEo----------M--T-TX--------E--B---T------------------------T-----------T--?-----M--?---X---------B-|------X?-----X-----T------M----X--B-----------MB---X----------XXB-------------M--B-------f
m---------o?----o--B---------------o---------?----E--|---|B--o---------?M----o-----T-------M-----?----X--------Xo-E---------------------B-B-o---B-E-M------------------E--o-------------------------B--X
XXX--XXXXXXXX-XXXXXXXXXXXXXXXXXXXXXX-XXXX-XXXXXXXXXXX-XXXXXXXXXXX-XXXXXXXXXX-X-X-XXXXXXX-XXXXXXXXXXXXXXXXXXXXXXX-XX-X-XXX-X-XXXXXX-XXXX-XX-XXXXXXXX-XX-XXXXXXXXXXXXXXXXXXXXXXXXXXXXXX-XXXXXXXX-XXXX-XX-X
