----B-o--|T-o----|--T-EX-------M-X-E--M|---MT-----B?M----|--T----E-|B------?---o-?-X-M--?-XM------|BX--o------Eo--T-M-----X--oM--M-oT--TE--T-M-|--T----T|B-T-----------X---?|T-------------T--|------M--
-o|----?-----T||----X--?-----T-----B--------T--oE-----?--E--|--T-----ET---X--o-B----X--X-Xo------XTX-----X-------T----E--o-|---------o--B---------B-o|-|E--M-|X------o---T---T-------T------?--T-T-X--E-
-oE---|------|---------E---T----oB--o-T-|--B--o--B---------?-?----o----M-------E------B-----?Xo-T-o-B------|-----T----T---------|------M----B-E-B--------M-B-----TM------B---------o-?---T---|----X-----
--M|----T--?---|--?----o----E--------T--B--M-T-X-T------o---------T--------MT---E---------BX|---o--?-?--o-?|--B--------------o-X-?-T---T---Xo------?--TT|MT-Xo--MX---------o--T--B--o----------?----B---
-T|----E---o----------T?E-----o-TB--?X---EE-T-|----|--------XE-----X--?E--MBM---M--M---B----T-----X-M----Eo--M-?---M----o|X----E------------------oT---E--------|---M------oo-----o-----T-X------E---?--
--|--B-----------T-|---------T--?X---E---T--T-----?-----M---o--X-|M---X-o--------B------o---|MT---|----BT---MBM--M-----?|T-----o----M--oX------X---E-E-------------|-?T----M---------?---T------?---Eo--
-------B--------X?E-----|-|--?------Xo-o---M--EX-|---M--B-----o-------o-X--|------oX|o--E-----M-----|---o----E-?---X------T---BM--oMT--T---?-o---Eo----E|-T|o--E----B-oXTo--M---EX---------X-?-------o--
-|-|o--|B-------E------?-?E---oX--------------------EB--------XB--o--B-------?|--?----T-----B--E------M--X------T----X-?-------E-B---MM--E-------?-------------B-----o----M-----T----X------------BEo--v
---M--E|--M-oMB-----M|TX-------?---XBB-----oo-----------T-X-o---------------------?-----|---o--?---|-------oT----TT---B---X------E---|-X---?----T--X---|--|----T-------E----M---M---T-B-----------E----f
--|T-----E-E----T---X-X-?--E---T------M------M|B-----|------------??----?---T-----B--?------------------EB-o|oE-|-B-------EE---------o----TEE-|-B-M?-----X--?----|XB---------M-T----B--?oo---X---|T----f
---?-----|-----|T-E--EEX---E-B-EM-E----B------------X-M|--X--X---XoT---M------|--X?---|X--------E-M-X-----?o---M-B---B---?-------X---T----B---o-----M--BTB--M----|----o-M--------------E------------?-|f
--------?BE-|o---TE--?--T-E-EEM-----T-?-B-M-?-----X--Xo-T?----B-o--|-----|E---B-----o----------X-----X----E--------o----oX--X|----------X---||T-T|----E?--M-----B--B--?-------E------E?---M----|-------f
---B-------o----M--|--?B--?------B----------------------o-----o?----|--------o------o-?T-X----o---oME---|-T---B---E-oTM-?--M------|----X-----o----------XE-o---|B--------X----ET--EX---T|--X-ET----B---f
--Xo-----T-|X-|----B--E?---ET--||--T-?-o-T-----------E-o-------X-B------X------B---E---------M-------|--T?|--T---T-T----T--B----E--------M-------?-----?--------?-B-------?-M-----|---|---X?----oM-T---f
m-T-o----o----T-----o--M-B----M--------T--B---M-|----M-----|------oT---T---ET--X-E------|--M?X-BM----------M|-------o---E-E--T--T---M----X---E------M--T---E-M----B-------oMX-o----------------?--T---BX
X-XXXXXX---XX-XXXXXXXX-XXXX-XXXXX-XXXXXXXXXXX-XX-XXXXXXXX-XXXXXXXXXXXXXXXXXXXXXXXXX-XXXXX-XXXXXXXXXXXXXXX-XX-XXX-XXXX-XXXXXXXXX-X--XXXXXXXXXXXXXXXXXXXXXXXXXXXXXXXXXXXXXXXXXX-XXXXXX-XX-XXXXXXXX--XXX-XX
