----|X--BM-----T---B-----?|---------To--X?---o---B-M-----M---B-----------|XB-----B-EM---o--B-T--|------oE-----E-Bo------------------o-?-EM-B---E-------------?---B-----?-oE------TBo---oT------?----BTE-
---X?----|------E--?o-----B-o--------o-TX-E--B--?----o--B-oX-ME---E|-------?-----o??----M---XE-E?-T--T----B---M--X--------T---XE-XM---------M-----T-?-------------|o----M------------|--------?-----Mo--
-MX-----M--?-----oo--XE-T------------o-----XB-TX-------B-----B-----?-B--o-B|-B---B-M-X--MM--------TEMo-----------------o|M---?-M--X-------------X----X--o-M-----E------M--T--X----B------?----TBX-------
-M----|o----XX----X---X-----M?-------EB-----------E------B---XE|-------B---M|-T-----E-------------o|---E--EB----E---E?-------M---|---X-M-X-----?M--X---M--T-----|----B--T-----B--|B----M?T----T---M---o-
-?-------X---|------------|------o-To-T-------X|---|X--M--M--?--?-----T-------oM---X---M---------B----|?--|------?-o-|TXM--M?--X------------T-E---X-----B?|X--T--------B-B--Eo-|-?--X?-M-|-XE-------o-T-
---o-----X-----E-Bo-|---------EE--M-----B|----o--MB|---B------E----|--T-T-----X--X-?--B--|-|----?B---T----BT|---oE---TE---T-|------------X?---X-------------?-------?---o--B-----M-----M----M--T--------
-------B-E------E-----------|-|-|Mo-----T--?X--------E---M----E----|-o-T------------E-X-?-MBX--o----X-----T-X-T|-M-E----?---oB------T------B------------------|--X---M---X-------EX--o-M--o-------o-E---
---------------------E--|X-B----M--E|-X------o--M|-?B-oX--T---------E--X--E---M-Mo----|----o--?--M---BB---------o-------|------------M-X------|--oEXEM-BB-M---|------oET--ooBB--X|EBX?---E--?----------v
-----|----E-------M----------T--XTM-----|--TX-----XX----M-o-?-----M-------T--XT----E-------X--X---------------o--|T-M---??|--B-------BE---X--B-B----E--E---X-T-|----o---XBM--?o-----Boo--T-----|B-----Tf
-X------------E-o-M-|----------o-----M---|---E---?-E-B--|---BT--------T-X?----B----M?X-|B---?T|----?-----------M-|--M------|-?B----TX---X-TB----T----|---M-M-------B-|-|----EE-E-o-B----------------|-of
-?M------?-------M-B-?B---?--E---T?-----------M--X---|--TX-------X---o---E---?-XE-B----XM-T--oo---o--------M------?--TB--X----|XXB-----------M-E--o-MB-----B--B?|-E-??E---|X-oTX??-?X--|---BM-T-----oX-f
-o--X-BE|o--T----TB------T--|E--X-T-BoB---E-------------o---E------o-Bo-----o?M---B?--|-|-X-M-?--T---T-------------------B-T--?------|------T-----X---X-X---oTE----B-X-B--E--T------|------M-oT-----X--f
-------E-E---X----|--M-|---E-TMX--X-----M-EB----B---M---------X---X-TB--------MX-?---EE-----?----T--B-T-----B-M--T--o-X---------X--|-----o|T--------M--o?-X--------M--X------|-E-E-o---?TB-------------f
-T----------oT---------------X|X---T--------E---------------M--T--oX--?--B|-----B----o|--?oT-M-E---|?|----M--M---XB-M-----EX-----T--|----o------|Mo?T---M-M-----------T-----XX-------B-----E------B-E-?f
mo-|---TB-E---|------------|-----o-----TB-MM-----B--------ET--E----|?-----------ToME--------T--o-M-----T---M-------M------------|---M--??--ETB-|oT-T------T--------------?|--T--oB------------T---o---?X
XXXXXXXXXXXXXXXXXX-XXXX--XXX-XXXXXXXXXXX-XXXX--XX-XXX-XXXXXXXX-XXXX---XXXXXXXXXXX-XXXXXXXXXXXXXX-X-XXXX-XXXXXXXXXXXXXXXXXXX-X-XXXXXXXXXXXXXXXXXXXX-XXXXXXXXXXXXXXXXXXXXXXXXX-XX-XXXXXXXXXX-XXXXXXXXX-X-X
