-----M----MM---X-|---X---------E-E-XTB-------Mo----------------B-----------M--------------o--Bo?---oX--X--------X-----------------------M--o------M--o------XMo---B-----|E-----T-T----------B-----?---B-
--------?----B-----------M?oX------E------------|---?-------o---XE-------------------M---------B--------B|--------o?-M------X------oM---T-E-------------|-------?---BB----M------|-------BE-------------
--------------T--------B---E---------X|-M-----------------B-----?---------------E-|---------B--o-B-|---?---------------B-----------B?--------------------T--B----B--------E----E----B---X--o------|--X--
--X?---B---M--X-------oM---M?----?----??---B----M----X-o?M---B-------|-----------E--------o-B----oB---X-------------------------M-o--------X----------------EE-----BX--?--XX------B?--------------------
------------M-----?--------B------|B---------X--o-X---------B---------------------------X---B--X-----?---TX-----X-X|E--BoE-----?------E-----?---X-----------X-------------E-------M----o----X-M-----XE--
------o--B----X-------B---M-----M-E---|-------|---E------B------T--------?------X?---B--X---X---------------------X?o-o---T--X---?-----X---?-------B-------------------------?B--------------B----o-----
-------------------E---------TBoTX----T-o----?-?-----X--o---------BE-?-------T-X-------X-o---BX----------------M-------o|----------X--XB-ME--o--M---B-----?-X---T---Xo--B--X------?-?-E-M-----B-T-------
--|--?E----o-X-X-------?-----E-----o-B----------o-----X----------TM-----B-B--------E-B---------oB-X---B----o-X--------------B---X-----o--------M-----E--?----------X--?----------X--o-------o------E---v
--X--T------?---------------X-B----------B-o----E?X------?-M---M-o--------T-B---?-M--M------X--------------?---o?-MB--X------------o---------o------?o----B------?-M--------o--M-|-------------X-------f
----------X-------------Xo-----------X-?------------------?-----|--oT--------T-M-------B---------X--B-----oX----B----X----o-----X-----o-----M|-|-------T--E-----------BMX---E---B-------BM------B-----Bf
----B--?------X-----M-------------B-BX---X--B----|-------?B---------?--?-o----M---------------oB---B?--B-----------EB------?-------------o-----M----|------------B---------o---o----B--X-----------T---f
----------------?----X---------??-M------------------------------||---------------B-------M----X--X--E-BX----T--------XX-X---B--T---?M----o---BE-----------X---o----------?------oX--?-?--B?---?-?-----f
------?-----XX---XE?-----------o-------B--?-------------E-B--o---T----?------------o--?X-----o----E--T---M----B-X---T----?-X-----M--oT--B---o------XM|o-?-----?-?-----------?o------T---------X--------f
------M--oB---X--------------------T-------X----------B--X-X--------X?------E-------?-----M-X---X-XX----E--B-|-----B----E-----M--BX-?--------X-----?-------------XX------M?----------?--------------E-Ef
m-o-------o?----o-?B--o---------------------------E------|--o-------X---M---------------------B-----------------o-------------B---------B-M-----B-E--------------------?-B--X-|-B----------T------EM?--X
X-X-XXXXXXXXX-XXXXXXXXXX----XXXXXXXX-XXXX-XXXXXXXXXX-XXXX-XXXXXXX-XXXXX-XXXXXXXXXX-XXXXX-XXXXXX-XXXX-XXXXXXXX-XXX-XXXXXX-XXXXXXXXX-XXXXXXXX-XXXXXXX-XX-X-X-XXXXXXXXXXXX-XX-XXXXXX-XXX-XXXXXXXXXXXXX-XX-X
