-------B-X---?-----------o-?E---B-------X-E-----------M-----------X--?-------E--------XX---o-B-------------?--------E-----X--X-B--o-?-----?---------------------E----------------X-----E-?-o------------
-------X------------o--B--o-----------------o---B-------------------o--E-----o-X------?o---------------?--------------M-----M--MB------------M?-------------------X?----------------------?----o--------
--X--------X?--E---o-------------o---?--------------B----MBo----------------oo--oo-------B---------M-----------------------?-----B-?-----------E-B-----X------------------?---------MM---------?-?-X-E--
-?---------M-X-EMM----------?----X---o----o?----X--------E----------?--------------------B------o-M----------X----B---B---o--------o------B------------M-----------?-X---------?o------o-------X------E-
-M------X------o-----X--M------o?E----B----o--------X---o?--------Eo-------------X-M------------?--E----X------------------------------------E-----?--------E-----------M--B-------------E---?-E--------
------o-?--------------?------------oB----------------B--------------E-BoE---------------E--E----?---------B-----------X------o----X---?--M-------------E---oX---------B---o----B----X--o---------------
----------------------------E------oX-------EB-----XB---------------X---X-o--------------------------o-Eo---------------X--X?BMo----?--------------X------?-X--------X----E-----M--------M---X----------
------?-----------------------------------X-o--E--?--X---?--M-------------E---o--B-E--------------------M-----?------------------X------E---------B--B------------------E--B--o----??------------------v
------?-------------?-----------X---?---------------------B---M-------o-----B--X------------E-o-X-X--E-----------o--B-B--?--------------------E-----oMo-XX---o------------------o---XX-------------E---f
-X--------o-o----o---M---M-B---------------Xo--Moo-o-------------o----------------o-----------?---X-------------------X--------------E--------------------B--E-------E-------oM-----------X----------o-f
---B--------B-------o----------------------------?-E--M--------X--E-----M----B----?--------------M----------------------o--X--Xo---------oo-------X---X---?E---M?-o--------------o-E------------------?f
--X----------------------X----------E--B-----oo-------------------------------?------XX------------?-M?------X--EB-------?----X-----o------X---B-----------M-----------------------o----------------E-Xf
------B-o-o-----------?-ToT?E-----?-|?TEE?-o--------o----TM----X-----T----E-o------TMT---|X-T-T--X--?M---?---XMM----o-B--------T--E----B--E-TXXoX|-E------X-M---TXM-T-T--X-ET--B---?TT--T---X-----?---Tf
------|---||--||T|---E|-M------|--MT?----|--X|M----XE-M----M|--E-|-T------|-B||-B-?X|--EB--||X-|---|------T|--------|-|---|-T-o||-|--|-|--?||-T---T-o-M---?o-|||||---|-o|-|-|||E--T-------T-B-||XX--|TTf
m-----||-T|---o-|----|T-|oETM-T|----E--T?|--o|-|---M||---?---||T-B--?--|T-|T-T|oX||E|-B---|--T--E-|-------?--|-o|-|-||------E-|TT|-|-|--T|--T-T-B|ET|-TMM--T----|o-|||B|--|---|-T------oT|T|EE-X|-ooT--X
XX-XXXXXXXXX-XXXX-X-X-XXXXX-X-XXXXXXXX--XX-XX-X-XXXXXXX-XXXX--XXXXXX-XXXXX---XX-XXXXXX-X-X-X---XXXX-X---XXXXX-XXXXXXXXX-XXXXX-XXXX-XXXX-X--X-X-XXXXXXX-XXXXXX-X-XXX-XXXX-XXXXX-XX-XXX-X--X-XXXXXX-XX-X-X
