---T----------o-?B----X---B-----?-M---------?------T-M---T----------?---------T-M----X--oo--?---T-|--B---------T-X----------------X--T----oT---------Bo------X---M-------------B------------------------
----oM---------------B--B-Xo---T-X-B-TX--?--oo--------X-?--------------o------T----o----T-X--------?T-o------X-T--------------X------------------X-------o?-----oo---M--X-X-X-T-----E-----o-------E-----
--EE-X-X---------E------X---?-----?---T----------T---M-----X----------?--?----?------X------T-?---|-----B--------MT---E---?----MX----X-o---M---X-TE---T---------------?-T-------------T--X--------------
-----|M-----E------o--M-----T-----------oXoo--T----T------------------B-?E------oo--------oT--o-------X-------T-----?---oo-BX---------E-o--X-T----X-?---------------|----X----T-------BT-----oM-o-?E-o--
-B-----------------------T-----T-----T-----oM--------T-o-------T-BT-------------T----ooX-----------X----------o-B--B-----------E-----B---T--------E-T---|-----o---T-------oo------------T----T--T-X-----
-----?----------o-----B---X----E----TT--M-T--?------------X--ToT----o-----?-----M------------------o----E---X---|--T-------T--------T---------?--T-??----T-X--------------?--------o-T?o---------ME-o---
-----M-----|------------E-------?T-o--------------------?------T----T-BT-EB------|-----o------------T---T-----B----------T-E-X?T--TE---o--T----M-T------------o--------|BT----o---T--o--------?----o----
--M-------B--T-----?---X-o-----X--------B---------------T-----T--T---------T-M-----o------------T-M------------B-------oB-----X-----------------|?--?-----E?-----T---X---o--------?-----|--B--------E--v
-E-o---?--------------oT-------|------To-XTX-B----------------o----------MT-----o-o---------X-X---T-------?----------T----------------?-|------T---------------------E-o---------|--M----X-T-B-----T-T-f
-B----------T--------------X---------?---------?---------|-----o---?-T-----??--X---T---XT-----?--o-------T-------B-----o--E---T---E-T----T---o--T-----------------T---o-----------X-------T----o--T----f
--o------------o-E--T-E--T-------------?----E-B---X-o----?o-------------XX--------o-T-B-|T----oM--o------X--X-T---T------To----------X---o-|------------------------M---T?----------B---X----B----TX|XTf
-?---------------o----oT--B-------------Too---?------B-o-?T-|--o-------------------------X----ETM--T----X------------Bo----X-o---------B--XT-----oT-M------T------B---o-----T?------Xo------------|----f
--T-?-T-|o--B?--BB-M-XoT------XX--------M?-T----XM?-------oM---T-M--T-oT--T?oB-T---?-ooM--T--XB-Eo-o---?--oXET|-T--o-----BB?o-XTT?---TXB-B---M-M--o-o-oT----T|o------TB-----o--X-----B-TToET-----?-X---f
-----T--BEo-T-oXoM-T---TE-E-----B-----E--Mo?--B---T-X-o-T--TT?T-TTBo?|oT---T-o------------B----TX--T----B--------B---TX--TE|XB--|-T-X--To----MTT--X-----T?T---B---MoTM--T---M---T---o-T-T----X---o--|-?f
m---B--B---BT-|----oX---|-B--------T----o?----M-------?-o?-ooX---X---o------oTT-T-?B--||------?-XB-----T-------E-XT-T-------oX-MTX-------?-o---o--MT-ET-----M------B-------o--BET-XT-o---E-o--XEE---?--X
XXXXXXXXXXXXXX-XXX-XXX--XXX-XXXXXXX-XXXXXXXX-XX--X-X-X-XXXXXXX--XXXXX-XXXXXXX-XXXX-XX-XX-XXXXXXXX-XXX-XXXXX-X--XXXXXXXXXXXXXXX-X--XXX-XXXXXX---X-XXXXXX-X-X-XXX--XX-XXXX-XXXXXXX-XXXXXXXXXXXX-XXXXXXXX-X
