-T------T-----TT---T----X------------T---------------?--X----T-----B---o----------M--B------X-T-----|---?-------T---X----------o--T-M-M---------T---oT----------X----EToT------|o-----------B--------o--
---X---TT---------------TB-----------B---------T-------XT-----------?---X---------o-X-----------?B-X-XTB------X---?--B-|----X--------TMX----------T------------------B----------T------------T----------
---------?T-o----------T-?X---T-----------oTE--M--------B--X-----------------?--B--BT------X---XB--o--------B-E-----?-?---------T-------To--T|o-M----------o--o--o----E--M--B--------------|-E-------|E-
------BX---o|-B--M-M-TT----T---X-------XBT-T-o?-E---M?E-o---o----X-X-T-----?oB---X-T---|--BT----?--T--------------M-------T-----X-?oX--X-------------M----X---B---B----B-X?-----BT-T---X--M-------E-----
----------------o--T------T--------------------B----B---B-X-T---o-E-X--X------------------B--o----------M-o--T--T-----X-?o-------------T---T-------T--|----------M-----T----|--E---------|X-To---X------
------X--?E----X-------?--X-X-----------T---------?------XB-------Eo--T----|-B--X----------------T------X|o----B--T-----X----o---?-X----?-o------EX--T--------E-----------------E--o--|------------|----
--EX-B-------------?B-X-------X----------B-o--B-----o-----T-----------------ET--T--------?----T----T----XX---------------T---?----M---------?oB-----T-----|----B-----X----------X?X--------|------T---T-
--------X------X-T--------------T-------------?-----X---T------X---------Bo-----------X------T--M-X?--o---------T---------o---B-o--o--------MT-o------M---T----|?---M----X----------o-M----E-----E--?--v
-------o--B---------------|-E------T?--XT---------------T---B-------T---B--To-----------o--M--?----BX---|T---TT-----M---------------?---------B-MX------------|----T-B---?-oT------o--T--X-------------f
--o--XE-------------B-B-----------------T---o-----TT---M--B----o----T---|?------o----X----------------o-E-T-|-------?----?---T----E------------B--X------E--M----T----X-----?-T-------E---E-----o--T---f
-XT--------o--------|-----B-E----To|-|---o-|-o---T------M----------T-B---?-o--------X---TE------------o--------X------------------------T--------------|------TX-------|-----------------T---------o---f
---o--T------T---M-T-X--?---|----|-MBT-?----XX---T-T----------M------XB-X--EB----------?o--------|-----|-----------------T--------BX-T---T----T-------B-E-----------TTM-------------------o-T?T--------f
-TT-T-B-XXT--oX---Bo--X--?-----o-oM-------TEE----------X-M--T----B-TM--oM-BX--E---X-B--B-------B----?M----X--Bo-?Bo----------oo?|B--oo-|oX----?o--XE--|----X-------To-ET-MXB---?-M----T----Mo--oTTTo---f
----E--------T-E?---To-----TMo---X--MTM-MoXTX------T-------?-|-------B--oX-----T--X--T--o--o-TE-T-?--Xo--To-TXo-----X--X|--E------------X-------?---M-E-T---T---T-E-----BTT-----|T---TX---X----XT-E--TTf
m--ET?o--B---MX-----?Mo-X-T-----X--EX-M--XTT----T---?|-EM-T----?E--?o-o-E--o?--|--X-T-|?----B-B---MXoTB-----o---T--M|----T---T?---TTXB--M-TX----T--BT-X---E---XXET----X-X-T--------XE-B?---?--TT---E---X
XXX-XXXXXXXXXXX-X-XX-XXXXXXXXXX-XXXXXX-XXXXXX-XXX-XXX-XXXXXXX-X-X-XXXXX-X--XXXXXXXXXXXXXXXX-XXXXXXXXXX--XXXXXXX-XX-XX-XXXXX-XXXXXXXXXXXXXXXXXXXX-XX--XXXXX-X-XXX-X-XXXXXXXXXXX-XXXXXX-X-X-XX-XXXXX--X--X
