---E------T|----o----T--E---M-----?---BTM---------o--------?------X--Mo-----oE||--|-T-?-|---|-T----M----B--|---------B----------B---ME?----T-XX--X--XXX?EB----M---B--o?B---M-E----|-|o---|o|---T----||--
----o---M--|M---?--o-E---X---X---|Mo--B-E---XB-------X-M-------|o---M-----|?TBX--MT--o|--?--Eo|--o--M-?----MoEMB-oM----o---X-M-------MoMo--X-?-----E-M--B-E-|o-----?-|-E-----BB-----T--------B-XM-----T-
-E----E------oT---o-|-o---M--E-M---oX-?-EE-?---?-|-E--EEoo|?-E-|-X---XoE--XoE?------?|-o--E-T----E------XE|--|---MB--o-T----?-oE-B----?----E-----------B|---M--|----E---o-X-M---?-|--|-?--------|B|-----
-E-ET?-B?----|--EB-??-ET-o---M--Xo---------?ToET-o--E?-EB---X--?M-----------B-T----EE------E-BEoXX--E-----T-|--B-M-B-o--?B--X---X?T|---------M-T----|---Bo--o--X---X-?E-B-----|-M--X?-E--------?---M-?--
-------ME--|-oo-M--T?--E|--oB--MM----|--ToX-?---o-oTX-E----oBE-B--------|--XEE--BBB-BT---E|--oB-oo-----To------B-o---Mo--E--EX---B--MB-----o|----XEoXX-----Bo--?X-X?TM------XB-|----TX---o-B--oo-T-|-|T-
-MX?Mo|-o---E------?-EoT--X----MTET|------TTT--Eo---ET-----B-XT----|-o-T-----o---BXTo?--X-?ET-M--B------X-?|-------|-X|--E-o-M--?------X------B-?EToE-X-?-B|B-B?|T|T-|-T-T---|----o--M|M-----oT---|-XM--
--M---To----|-Xo--oM--------?T-M-M-----------T-----?--T-?-------E-|-T--E----E-M---oM-M?-E-?---?-TE-|-----||--E-o-----o--E---?-T|-------E------------o-?--------X-B----M-X--o-o|--?-------?------T--?|B?-
-M-B----||--o-T-oM---------XB--|-|--|--X------?-oo--?X-?-?---|?o-B----X|----X----?------T-TE----X-------------||---X-E-|--T---?--X--o--B----E-BE--?--?M--o--X---?--E----E-?--E--M--T----BT--o-M-X----M-v
---o||E----?-?----BMX---M-o--MB?-?----T?|-E------XE-?--??--ME--B--o-BX------E--M--E-B-TMT-----|-|T?--XXX-T|--M-|M--||----X-B---B---EEE---M-E---ET-o-T-|-?M?BEo-T-E|-T-T---E-----|-|-----MM-E----|-MM---f
--X-o-E?-o-T-oT----o--X----|--E-EoM-?M---X-?--o---------M|-M-----X--T-?--------B---?----------B-----BE---E|?XM------|-----E-T-XT-o-M-T--|-------------|T---T-XB-XE-E--E---------E--|-B?-M?--X-?--|--E--f
---o-o----|To---X-T----M----Mo-?-----?-B--|T--X---X-----M---|-T-o--?--X----M-E?---B----?-|-T--E----|-X-X----T---T-M-|--BX----|o------XB-MTBBBM?-|--T---?T-B-----BEE-?---?---oM---?----o|-X?B?---T-|----f
----|-|--XM|--|-oT------X-M-EE-B-----o---T----|-----|B---E------o--o----?-E---E----o---B--|BX?BXB-TM--E--?TX|------oTEM--Eo-?---?T-B?---?|--E--o--B----?T---M----?E--o--T--E--?------|M----------|-----f
--B-X?----?-T--EE---------TX----X-M-E----o-----B-------?-|---|TET----E-XT-TB|-To---TM--------|X|---T?B---X|-?-??-----------?E-?-----oT--T-?X--|E---oM--------TE?o-|----o-----|-o-o-B-?B|--M-?-E---BB--Mf
--oE-M-M?M---|-?------E---Mo---Mo---XX---?-------M--o-------X---o------|----X--------E--oo-MB-------B-o-o|M---XE?--M-BM--?oo--|-?o-X----o------M----M----M--o----||-?----|--?-E?---B--?|o-|--XE-X|-o---f
m------?B---E-|---T-|-----TXT------|--?-X|----To----T-M-?T------o---E|-M-T-X-|B---B?---X---X-----------Eo-oE--o--o---oM-X-E---------|-|-Eo-----|-o-------EE-?o-?-o-X-|----------oEX|----|----|--?--T---X
X----------X----------------X------X------X--------------------X----------XX----X----------X-------X-X-----X-------X--------X-----X---------X------------------X-----X------------X----------------X---X
