---------?------X?o-----M-----o-------E----------o-X-----M-XB---------------o-----B--o---?--------------o-----X-------M-M--------M----EM----------------?E--?------X--------X---M----X------------------
--------E---M----o--X----X---o-----------oE-------X------------------------------M---X--M------X------------B--------E--?-E---------B----MX---X-----------o-EX-?-------o-----o--------------------------
------X-E-------M-M----------------B----------M--------------o---------M------------X----oB------------------------------------------------M--------E-----------E-----?------X-----------?B----o-----E?-
----M-------M---------X-----oX---------------X-----X------------------oo--X---------E--X---------B------------Mo--o--o----B----------?oB--B---E--?---o-o-X---o----------------M----o----B--o------------
---o-------?M----E-?-------M--------o-o----E-E-----o----------X-E----o-----X--X--------o---------------?-----M-o------?--o--X-------o----BBMX---------o-------B-----------o--------------XX-----------B-
---M-----------------------o-----------?-----E-------X---------?o------------?o----M-------------Xo---------X------BM--------B-B--o--oo--------M----------------E------X------------XoX--?--------------
------------X---------------E---?-o--------X?--o-B----X---X-o-X-------?--o-------o----------o----o--X----?---------------------o----------------X--o----M-X-------------B-------E----X-------Xo---------
-?--------X?--------M----M------M---M----------M------oX-X-----------M---?--------X-----------------------o-------------?-B------o----X------o----oX---o----------?------------X--------o--BBo--------ov
---o---M--o-----------------------E-------X----o---X---o?-------------X------B---------E------------o-----------------X-o-X------?-oX--------?-------M--X---o---?----X-X--X---------------X------oM-M--f
--------------------E----B---------?-----?--E----X---------?----X--X-------o-------BM----B-------M-------------------?-----o-------------o-------------------X-X-M--E-E-o---BE----------o-------------of
------M--------o--B-----------------B-o------o--------------------M---------E-XX------B-E---------------------------o-------?------------------------X-----M----o----M-E------------?------M-?-----X---f
-X-M---------E----o-----M------------oM--------B-------X----------------------E----------B-oX---------o-----X--------B---o-----|----------------E----M------E--o--X---------------------o-?------------f
-E----TE--T--X-----X---EToX-T----B?o?-E--B-M-B-o--E---E-oT-T-----X--------E--T--M------BXXT------B-X--M--?-BT-----?-M--MM-o----X--?----T--MEMX--E--T-T?-oo-------TMM--oB---oTMo|---o--T----E--|X-o??---f
--oE-X-E--Boo----BE--M-----M--TT------E-----?---EB---T--Boo-X----T-|E----|M---oT-------||----BXoT--|T----T--XoXT----T-----------ETX-----T?BT------o----X--?--T-T---M------B----o-XE---BE--XB-o-M--?-o--f
m-T-------T--|oXo--o?MT--T-TTB-X-----M-MT----o--o---E---o---T|---To-o-TX----?BB-?EBX-?--T?-To-B---?---X-T-------?|--------T---oBX---T--?-ME-E?E-B-T----?-o-?--?-T---T---oM--|oo---B-X-T---BT-B-o--X--XMX
XXXXX-XX-XXX-XXXXXX--XXXX-XXXXX--XXXXXXX-XXXXXXXXX-XX-XXXXXXXXXXX-XX--X---XXXXXXXXXX--XXXX-XX-XXXXXXXXXXXXX-XXX-XXXXXX-XXX-X--XX-X-XX--XXXXXXXXXXXXXX-X-XXXXXXXX-XXXXXXXXXXXXXX-XXX-XXXXXXXXXX-XXXXXXXXX
