-T-B-o--X----?-ToTTTBM-E---E?MTMMETBT-T-T?-Bo--MMTE--T-?ET-EoE?-oT?---|-T-XXMo--BE|TB-M-?XT-BT--MT-TE-XET?XXEoToE-T?-o-|XB-?E--E-TM----T??T-T--X-XTM--T?EXE???T-TEETX--E||--B-BoM--E?-X??-X-oX--EX-E?---
-Xo--?TooM-TX-TTME----X|MB-TTo-oXT-X?X-?--X-TX?M?-M?MX-B?TTET-T-MBX?--B?--TX-o-TX-B-T-?----EE?o--X-XB-XTX?-T?To--MTTE-MBTE-|TT-XXBXE-MToXT-X----o--B-Xo--T-|MET?TT---TM?--E-X-TETBT--M--Bo-|ToT?--oB?-?-
-o|oT--o----TXTMMB--TMX|MBTEoX--?TMT-BoTo-T---o--B-?||---oX-oBoTo-|--TBB-X--ETo?---T--E-oXTXMoT-BTT-TXTo-o--XoX-oXoEBX?E?-T?X--XTM|?ET-E---TMX--B|X?T?-X?--oTMT--?ooT-X-M-M-oBooT?T?o?----BTEo|-TTMMMo--
--X|-|oTXBT-?TXXE-TBT-T--M-o?TET--?---T--TTME-oB-XX-TT-T?E|E|-X-T-BXoEXToT--XoEooMT--T-?-To--TX-X-XXM?oEE-TT-o-BXT-Xooo---EEXET----E-TME|-E-oM-?-TM--BoT-----B?o-XX-TTTTXT-TX-?TTE--oo-XEEToTTBB-TTTBEM-
-??-EB-X?--XXMo?oTMo?BEoE-TET?-T--oT-XT--oX--ToEEo-TT?--oEBT-TTB-X-TXB-ETT--Xo-Bo--oB|ETooo-MM---E-ToX?TXoBToMBooTT--o|Moo?--XX--MBB---TXMT-?T---ooBoo?ET-To?-XEE--T----M--BooMT-B-TX-Xo-TX?-BoTMoTXT-X-
--X-E-o--TB|-X?--XT-M?XB-T-BXMBT-o-XTT-oooT--B?TXT?-ooo--MTX-XE-oXX-T--?oo--TXX-oTXT-BTE?MX-?-MooB?TBT--T-?T?T--XB-?--TXoB-EoMXoET-B-XTX----EoTXT-MEEB-ETE?ToXo--TXB-?TTMX?E-X-E-o-X-B-BoM-T-??--ooX-MX-
--Eo--TM---B-X?B-XB-T-T-o-?X--XXBXB--MT?EX|-TEo?-E-o---T--oM-TT--|oM?---|--oBX-ToB-oXX?-ET?T-TXMo?-XT?BE---oBTT?TBXo-MTT-BB-BTTXM?XToXTB?o||BTTXTMo-XB-|TT-T-B-TX?--?MET---M?M-o-?-E-T-To--E-ET-o?---|--
--TTM-TTo---XXT-T--XT|Mo?--METToE?T-o---o?TB-MT--EX-XX-TTTXM--ToTTXB?-TToT-oTo?-T-E?T-T---ToBX-BX--XT?TT--X-MoXXTT?|o?-B-?XT-?BT-Xo-oXT--TXETo-Mo-B-Too|-T-M--XE-o-M-XM-X?BBToMTBXXXM?---EMTEB-oTXBE---v
-TTooo-M-oTTTTX??-?-XEM-XBBTX---oXTTM-|E-ME-M?B-oMTB-BXo?TTTB-XTT-|XT-TX---oTo-o-|X??-T|oBT-XX--?-XB-X---oMBoXEoB?o-BMET-oB|E-TToT-?-TTMoMX-?T-|TooBB-XTM-EB-o--T---MT???-TX-XTToXBo-o-BoT|T-BTB-X--|M?f
-MM-XTTo?-X--oo-??E-XMo--T-?-TXT-X?MBo-B--|ooE-T---BM-M-o-B?X-oXXToo-|o--Bo-oT-TTTT|M-ET-XE--BoEXMEXB-TTE-T-?XM--T||----EM-X-TT?XTo--Xo---M-T-TT|-XoBX?BTXXM-M|XTBT-TE-|-MT--ETo--oXMoMT-|-?--T-?oTooB-f
--Too--B--Mo-T?-?X-XoBBXXT-o-X-M|oT-oT-o-ETEETXXX-TM-XToTB-?-Xo-BB-X--Xo-B-X?oToX?o?MX---TM-B?-o-EoTMX--M-To--E?-T-oXBBoT-E-XTXTBTTTX-?E-T?--o?XMX|o?X?-T||T-o-?TT-XBooTo-METT-|ToM--|oXTTBX|--TE----X-f
-X--oTTTX-B--T-X-ooXo-|---TX-?T?X-o-BT-?|o---B-MB-TTTBo|T--TEB-TT--TBT-|oo-o|-XMTT?T-BT--X---XoT?o--M---XXX-EX-E--BT-T-?Xo-?E-XXBoM--|T--o-MT?ETo-XBT-T--?BoBT-XBTET?-?-T-TM?T-oX|TBEX-TBXTB--?-oX-X-BBf
-X-X-o-oEM|-EBB--XX-B--MBBXXX?B?---BX-E?--?-BXXMBMB-EM??o--|oTBoBE---E--?-B-?-?o?XM?-o?---ME--XBMoXMX??|XMX?Eo-oE-EX-X-o?MX?XB-BX-XM-BE-oEB--M-M--?B-oEoo?---o-?B?-?-oX---o?XBXoX-XX-BX-X|--o-?-o---B--f
----BoBo|-----XXXEXBMo-BXX-Bo-oETB?-E-|?|-oME-MToX-EXX---MXo--X-oTEo-XM-M-oX-MoE-M?BB-|EMT-M?M-M?oB--X-BT-E?oXX-T?oBM-B--B-XTBB-X-B-B-?--ooX?BEXoE?o?BX??-o|oX?Bo?XM?TBoXXM--oX--?Eo?M-----?-?ooEoo?XXXf
mB?--E-B-o?-Boo--BB--oTB??-o-XMXB-XMo|MX-o?EB-M-BX--?-XXBX?B-oXB?EXXo-?--XM--MMX?EXX----XB-oE|?B-Bo--o?XBoB?-M--MBooX--X-B--XBoBBoX|X-MXT?-X--B-?-?--?M-?XE-oEBMB-BBM?B-ooo?-?-BM-E-Xo-XoEEX-o?-EXoE--EX
X-XXXX--XXXXXXXX-X-X-XX--XXX-XXXXXXX--XXXXXXX-XX--XX-X-XXX-XXXX-XXXXXX-XX--X-XX-XX--XXXXXXX-XX-XXXXXXXXXXXXXX-XX-XXXXXX-XXX-XXXXXXXXXXXX--XXXXX-XXX-XX-XX-XXXX-X-XXXXX-XXXXXX-X-X-X-XXXXXXXXX-X-X--X-XXX
