----o-----oX-----------o------?-----E---?--------------?-----?----------------------X---XB-----------X-------EB------M-------?-o----X-B----------------B----M-------------oo-----o-----o----M---------?-
---B---------B-----?---------------------------------B-------------------E----o------------------X---X?-------E--E--------------?-----o--------------o-------------------E------------------------------
-o---M---E---------E--------E-o-----X-------------?--------------------o------------M-----X-X--B-X---------------?-----B------------?-----------------?--o---M-------------?-M-----o----X-------------X-
------------------X--------------------------o-X-----?-------X--------------------X--------B-------B--------------------------o-------E-------XX-----X----------M-------------------------------------X-
-----------?--------------o-E------------?---------X---------------M--------X------B------oo--------M-----------------B---------M?--------B-----------o-------o-----X--?-?-------o-E---------o----------
------B--------------E------X---------------------------------------------------------E------------B----------M----o------------------------------o-----------------X---?o-------?--o----M--------------
------?-----X-----------------------MB----------------B------------X-----------------X----------o------------------------Xo---M------------------------M-------?-------------------o--------Bo-B--------
----BX------------------X--E--E-----------X---M----oE------------------------X---X----------------------------------?---?-----o---MXo-X-----o---------X------------------X?-------o--------------------v
---------------------X---------------------o-----M-?----X--X?---E------X-----------------o------------------------E---------o---------------o-B----BB---Eo--o--E--------------Xo------E----------------f
-M----X--X--------X----E----------------------B-----E-------B---X----------B----Eo--------------------o?-----------?---------o-------M?--B---------------X--------------B----------B---B------------B--f
-----X------------M----E--o-----o-?----o---------Eo-----E--?E-----------------o----------M---------o--oB--E--X----------X-----------------B-X--B------B--------------------X----o---B------M-----------f
--B---------X-----o----------X---------M------M--------------------------------B----B-?-----o-----M--X-E---o------X-M-----------?---------------------o------B-X----o----------------o---?-B-----------f
-----------?------?----E-------oE---------MM--?X-oX-o----------?o----B---------E-E---------------?----B----------o-XE--?E----M-----oB-E-------------M---Eo--o-M---------------B---o-E----B--XXB-X?----of
-------E---------------------E----------XX----XB--B-----------T--E---------------T----------X-?----------------------T-T------?-T-T-E------------BE-X---E-------E-------T-?-ME--Xo---o---T-TT--M-----TTf
m---------oX----T---------T--?XT----E------T-B-T-------TBB-?--|----X---X----?---?|E----T-----------------|-------------|----EX--|-|--o---T-------E--Eo---E-----E----?-----T----|-?----o-E---|--T---E-||X
XXXX-XXX-XXX-X-XX-XX-X-X--XXXXXX-XX-XX-XXXXXXXXXX-XXXX-XXX-XXXX-XX-X-X-XXX--XXXX-XXXXXXXXXXXX-X-XXXXXXXXXXXX-XX-XXXXXXXXXXX-XXXXXXX-XXXX-X--X-XX-X-XX-XXX--XXXX-X-X-X--XXXXXXXXXXXXXXXXXXX-XXXXX-X-XXX-X
