----E-E--E--E--?Bo-??----?-X---M-oMBo-BM-----E-?M?------B--MBEEXEE--B-?M-------M-----E--X--B------EX--Bo-M-E----X------X?-?M-E---B-----X?----?---X?-oME-?MX-?-M--E--X---M-EE---?---X---B------o----B-E--
-X--------E---B-E---------?----?---X-----o-?M-o---oMo-----M?-o------------M---M--E---o-M---X--M--B--EM-o-MoM-MBX-o-----------?---E--?-?-X-oo---?---MX--M-M----E---------B-----X-X--XB-X-M-X-----XB---B--
--XB---X-------E------M-Mo---B-XB-??-------EEo-E----B---B----EB---B-M?o----oM----M----X-B-----------B----EB-E------E--X------M-X-----o-?-----X----?XMB--------X---M----X--M----X-X----X---EE----X--?-?--
--------M-?---E--BBoE--E----E---X-E-??---E---M---XXMEo----M?X--------?EB-----------------E--?X------?------BBooM---E-?-----------o-M---?----M--M--M-------?M---X--o--M-EM----?-X-X?E-?------MXBM-M-?-?o-
-X----?-B--E--M-MBoX---?--B----E--MX---M---o-----------M-X---X-BX--MEE---?Mo--B--?--E-M-XXoB--------?M---M----oX----------------oMM-E------?----X--oM--X-o--X-?--X-----MBX-----E---X-B-MX--o----MMMX?---
-Eo------?-o-oE----X--o-X---B?---M-------B---B?o--?-EMXEX?o-E?E--EXoE----o---B----E-E-B-E---X----???--X--X---X-EE---B-------M-BX---B----??--E--E?---o-------X-M----------MEo?-------oB---E--?--X-B-B--M-
---E-X----o-E-E-B-X---B--X----E--------B---E-XoEB-?----o------BX?---B-------?---X---EX---M-X-B-------X----E-MEo--EXX-o-BB-B--?B?------oX--B----E--?--?--MBEX??-?---XX-B-----oMEM-M----?-B--E--XX---o----
--BX---?--?BB------MB--?o--BM---BM---E--E---X-X-------BE?--?X---X----------------------X--?--------?------o------B--E----o---?---E---X-----o-?---XX?-Mo-E--X-X--E--?X----o------?-EoB----XE?-MB-M-o--XBv
---X?-------?---?--o-BB-B--?-Xo-B?o-?----------M---------------M--XEo---?M---M--o---Eo--?-EXX----E---M-Bo--M-o-o-M?-XMoX--M--B---BM-?---------MB-B-M--------M?-o--E-?-X-----------X-B-M-oo--B-?---??B--f
-?-X--M--XB-E----?-------X---MoX--E-E-E---X--XEXM------E-----oB--o----?---EX-o?--o--M-EB-XMM---E----oX?-XE-X---?B---M--XB--B--oEB?o--?----?---?---oBMBX----Eo-o--?-X?-M-o--BMBo---?o-?--M--E---M----??-f
--B-E--------XoB----------M--E--E---o-ME----?---o--X-------?--o--?--XX-X--o-?--?---o---B--E---?-----o-?--o-----------X-E?-B--B-B----B?X--B-E-oBM---BB-E---?-o--X--ME-----E----oM-----o?--B------X------f
-----------BB-----------oB-o--B-M---?---E-M------?E?-------M-M-o-E---M-?M----o---o----B--XM-Eo---EX-?o-M----E--o-E---MB---?B-------M----EX-oX--B----?B-?--o-------XM-?-?X--M----?-E--?o-o--o--------o--f
-?-oM--?---X--?----MM-X------ooE------E---?----M----o-----o-ME---E---Bo-----XB-o-?-------E--B-E--o-BM-----EB-------X?--------o--Bo---o-E---EE-?----oE-M--E--o--?MB--o-X?-BBM---E---o-E---?----BX-?---B-f
-o--X-----B-E-B------------?-----B--o--BEM-M-M-?-?---M------X-----o-E-?-X---B--X----E-M-XM--M-Bo--oX--X-------B-M-------Bo?E------E-o--X-------?-?-M------B--B-X-X-M--o-EE--o------------?X-X--?E--o-?-f
m------------------------------------------------------------------------------------------------------------------------------------------------------------------------------------------------------X
X----------------------X--X---X---X--------------X---X------X-----------------------------XX--------X-----X---------X--------X-------X------XX-X-----------------X------------X-------------X----------X
