-------B--o--?------EXo---------B---TX------?---------E?---X------B----M----?--------------X---------o---o-M?--?B----?---X----o--------o------B-----------X--MBT---XT-o-E------M--B--------------o---B--
--------?X---------|---B---------?B----------------???--X-------B-o------o--X-o-M---------------------------o--BX----M-T-----o---E--------E--X--M----|--B---B------B--|------B---B--M-MX---B-E---BT-----
-E---o-B--?----X--------X-------T----EB------------?-Bo--XB------------EM-B-------|-E--------M---o?------E----------------B---M--------M----------X-M?---T---?---------|--X------------------T---o--?---
--M--XTB-B-----------?-----------?-----?--M-------------oBX------o-----B-MX--o??----E---------------------------|---M-?-------|-T---ET--------------------o----E---B------------?-o?-|oX-Eo-----T--?BB--
-----------|ToE---oXB------------------B----------T--------BXM-B---?-B-----XX----------B-----XMX--|------o--------E----B--B?----------?--E-----B----------------------?----X----------Mo----------------
---------o-----------M---X--------E-B----B----o----B------|--------B--------------------X------------B--X-----o----Bo------B-B--B-------M--E---M?---o---X--------------?-B------------X---X-------o-----
-?B--X-E----B------------o-----o----B--E----------------X-B-B------?-?---B---?--B----|---B-B--XMT------------EB--B-----------o----o-------?-----X-E-B-----?------o-----?---|-------B--?oE---------------
---------?-------M--------B--------------------T------------------------X-|-------?----------X----?-----XM---M--XB------B-X-----?-X---?----XB--------?-------B--------M---M----|----o-------?-X-----B--v
-B-MET----B-------B----T---X-----------T---------------??-----E---E------|---------E----------o----?----?--??----B--X|------o-------BX---B----oM-o----------------TMX----------------X--B-o---------B--f
--?-----|---M---oB----------?---E?----?---T-------------------M---------E-----------------?MMo-----BoMX---------B-----o-----|---------?-------oE-----M--?B----|--M------B----E-----?---B--M--?---------f
---X-------B---TMB-------B-----o--B-B-------BB----?--------ME-------------B-M------------------B-----B-B-----------M------------------E--M--|-B-------------E----------X----M---?-----?--------------MBf
------?-----?-------------M-ET----------------ME---|-----M---------B--o-B-E?-------EE--------X--------X------X-------E-------------X-------------------B--------------X------------------X------?------f
-----------------------------E-T--B----------X-----X-------------------T--X-------o----Mo--|X------------M---------|T------X--X--------?X---o------|--------BB--------E-----------XXX--------MX--------f
-----o----M-------M---XB-?-o----------------T-----M---B--X------T------------|B---M?-------X----Xo------X---E?X----MB----------B-------------o---o-o-----?B?--|------T--M-XTo----B?---------------B----f
m--o-XE---X-----X-----o--E------|-----o----------------?T--M-----?-----BM---o-------------M--|--------X--------T-----M--------------E---E--------o?---------------E?--|-----|-B---------------B-----?--X
XX-XXXXXXXXXXXXX-XXXXXXXX-XXXXXXX-XXXXXXXXXXXX-XXXXXXX-XX-X-XXXXX-XXXXXX-XXXX--X-X-XX-XXXXXXXXX--XXX-XXXXX-XX-XXXXXXX-XX-XXXXXXXXX-XXXXXXXX-XXXXXX-XXXXXXXXXXXXXXXXXXXXXXX-XXXX-XXXXX-XXXXXXXXXXXXX-XXXX
