-X---?-o-X-----------o------M------X-T---EX--------X----?-----T--E--T----|-o--TT-----o--TE----o--B-B------------------------------------B-------Xo----M---------------T-------TX-T---------T--------TB?-
--?--XT------X------------Xo-XT--o-----o---oX------B--E----T-T----B---M-?-TT--X-BT--o?Xo--o-----o----ME--T----------T---?-T-T-T--|-o----M----?T--------------T----------T------??---------|---------TT--
---------?X-----E--B--------T---T?----------------B--o----?--------------------------T----------?E-T-B-X-T-----X--o-X----------o--o--------------o-?B-X--T-M-X------------------B------?----------o---T-
--|---T-TT-------------------o-------T?-EMTB-|--E----T---M------X----------B----------Xo-----------------------|---T-X---------------------T-------M-------X------T------------------B--------Mo--------
---M-?----E-E?---?|-------T---|?------o----X---?---?-------B----X----------X--------------------o-o-EM-----------|-o------E-------T---------o----o--X-----------------------TB-T----XE------o-----------
--------M------B?-T-?o--X-------------TTo-M-T----T---------T--------------oo--T-TX---T----E------------T---|-BBT-T-----------------------X-----T-----BB-MT-----------oT---o---TT--T----------o----BX--M-
---T---X-T---------M------X----------|-----T---------o----------------M---|--BT------?--------T-------o--------TB------o--------?-------|-?XXM-M----X------T--?T--------X--T---?-E-----------oX---X--?--
-X---o---X---------------T-------X----------X----T-|---T---TT---XT------------------------?-----T--T--|-------X--?-----B-------------------?-------B-T-T-B---T?---T-----X--X-T-?o?-------T--X-X-------Xv
--B-------o------------------------------X-E-------------------oo-------E---------------oo-T-----------TT--------T--------T---T-----?---?X---------?-TT---XT---------B---------E-T--------------T--X---f
--|-----------B----E-------B-|-------------M-X-----BB-T-----X---B----------?--------T--o-------oT-X?------o-----------------T--X----T------------T-o----X-----------------------X-----T-----M---------?f
--o-------------------TM----oET-T-X-----E--------------------------X------T-TXo----o--BM----------X-To----o--X----T------------------E?--------o-----?----T-------------------B--------------B-----oT--f
----T-E-----------------T---BX------T----oE--?----T-----------X?---------TT--T--B------o-----------B-------ET-?----BTB--------B-T-----------o---------------------------|---o----------o-X-B-?---------f
-T-o-TT--o--oo--?------o--T-T-X---o-o-----M---ET-?-----MBX-T-?---B?X---T-o-----BXEE--|X--o----oET-X-----M---BE-?-?---?-T---T?-----------o-----T-----BX--------B-X--X?-----X-o----------?XBTE-o--X-E-T?Tf
-o-------?XX-T-T--EM--?-M--?-?---------M-MX---M-E-----o-o------MTB-|--?X--B-o--oX----------X----oo---TX?MBX--T-?-XT-XT-M-------T--B-TT?-T--B------?-?---M-E-TT-o|-T--X-XTET-?-T---T--XT---?-TXTX--?-B-?f
m---B---E----X-M---T?XoT-T?---B--TT-T-TX---o--BETMX---B-XE---o?|T--X-o-----------XoBM--o----T----B-EM-----T--X-?-ooMT-B--o-B--To?-o---ME-X---MT--B----------X-oT--B-X-T--BB-B?o--o-M---X--?XT-T?EB--EE-X
X-XXXXXXXXXX-XX-XX--XX-XXXXX-XXXXXXXXXXX-XXXX-XXXX-XXXX-XXX-XXXXXX----XXX-XXXXXXX-XXXX-XXXXX-XXXXXXX-XXXXX--XXXX--X---XX--XX--XXX-X-X-XXX-XXXXX-X-XXXXXXXXXXX-XX-XXXXXXXX-X-XXXX-X-XXX-X-XXXXXXXX-XXX-XX
