-----M--X------?---E---?----X------o-----------X-M--------o-----------E--X-X---B-?----------------X----o--------------------o------o----------XB-X--------------?-------B--XB---o----------------o------
-----?X-E-----------------M-----o?------M?------------o---------------X---------o-X--------------X---EX-------o----B------M---o-----------------?-?---------B---------------------BX---M---E------------
--X----------------B---?M-----o-B----E-------------o--o-----------------M--------B--------?------X----Bo--X----E--X---------M-------M------------E-----?-----E--o-----------------------oo----o-M----X--
----BM----?--o---M------------------MX-----?--E----B-----------B---o------------------B----------------------Bo---M-------------oM----o-------------B--------B-o-------XB-----------?--B-----X--M-------
-------------------XBMX----o------?----------------Bo----------o------o----------X------?X-oM--M-----------X?---o--B---B------o---------BE---M----------M----------E--X-E--?-----X----------------------
---E-X-B-----------XB-------Eo--------Bo---E-----E---?----EM-o-----------------M----------B-----------------X?--------------X?-------------------------B---------B-B---?E------------------B-------ME---
------XX----o----X---o---X------E----X----M------------------------------o-X------?-----XE-?------X--------------o------X----X-X-----?----------oM-X-------?----o?----M----------------Mo----------X-o--
-M-------------X---X----X-----------------M----B------o--------o-----X--E----------------M-B-----------X---------X----B-----------o-?-----?--X------X-------??---X-------BM----?-?B--------X-----------v
--------o--?---?--------X-X-------------------------E----------------?-E--o-------o---M-----X------B---?-----X----E---o---M--------X-------------------E-------------o--?----B---------o---------------f
-------X------X---M-------------------------------MB--?--E------------X-------------------o----------?---E---o---o----------B----X---------------------------o------B----?-?---M-----o----?--Mo--------f
---o-X--------?-----E------B---B-------------------E-M------------------------B--E----------o----X---X?---------------?-----------------------------B?X----M---------B---------?-o------?------X?M-----f
-----B--------X-X---B---M----o-------?---E----M---------------X--o--------XE-------M----X------------o---X-E-?E--------------o---o--------X-----?------Bo-------B-----------------B--------X--------o--f
-B----X---B----EB--XE-BE-TT?E-?---X--|--o?T?---oXo-M--M-|oTX--X-M--X--E-----E-M----Mo--oM-Eo--------TX--M|B-o--B-T-XTX--B-?ET|-X---?ME-oT-M-X---TX---E------T-?-|T---T---T---?M-XEo--XToXT?TT---BM---?-f
------?-X--Eo---TB|-o-XT--o---oT-|---TT?X--B-B-To?XT----o?-T|X------o|-|-M-o-B--X------M--T-|---T-T-ToM-X--------o-T----X----T-B-----o--o-------X------oTT---BT-o-|T-oEX----o-----TXo-T--T------B-?-o--f
m-----X-M---?-TX-B-T-o--E-ET?----???-X-X----TT----|T--M-T--oo-----T---B---TBo-X----------M-oT-X---?---|X--|---ET--X?------|-----X--X--X--XETX-XTBT--T---T------EoTTo--o-Xo---|T-B-XT-E---ET--ET-T-----TX
XXXXXXXXXXXX--XXXXXXXXX-XXXXXXX-XXXXX-XX-XXXXXX-XXXXXXXX-X--XXXXXX-XXX-XXXXXXXXXXXX-XXXXXXXXXXXXX-XXXXXXXXXXXXX-XXX-XX-XXXXXXXXXX-X-XXX-XX-X-XXXX-XXXXXXXXXXXXXXXX--XXXXX--XX--XXXXX-X-XX--XX-XXXXXXX-XX
