-?-o---?-?Xo|???--?BXoo-X-Bo-Eo-XM-X-E-MX?X?-oE?E|-XX??---XX-X-XoX--oXooX--BT?----MXEBX?|B-XoM?M---E??-?E-XX-o--X?M?B----o-?oM--?--?XBB-?-??M---o-Moo-?X--E-Xo--??---oBX-X-o-oMo-?Eo-|-XEooooBXoB-?-T?--
--EB-|MX-?-BBB-X?-|-E-Xo-oM--??-o--oEX--M?X---X-To-XM?-Xo-BEXE--o-o--X-XX?-E--|-E---?BBoo-o--o-E-B?XXXXM--|oEB-BB-X--X-E-?oo--o?-X???X--X-?-o--B|?EoX|?---oXoBX--B-----E-o??X?X-?-X?EX-B--XXB-B?-|Xo-M|-
-?X-E??XX-?-BT--EM--T-BMB-XoX?ooMoTBBE-EX-T--?-E?B?-To-T-X?XX-X--TX-?Mo?-???--X-M?X--MooB-ET?B-o----X-X--?E---o?-X-BE--oo-Xo--?B--XooEX---X----XXM|X-o-ME--B--M??M---?-?-E-oX--X-o?o-EoB?XXXM--?-EX-MXo-
-?-o-B-TX-oMoX|B-?o-o-E-?o-?--X-B-B---o-oX-EEXXo--o-|X-o-X?--MoBB---E-|?oBE-X--M-o-o--o-BT-??B-B?EX--T-XX-X--?|B--oE?XBT-XBTXX-MM?---XoE----X--MBT?--ToB---???X--XXM-MM?-X-XB-?MX--MXo----?oXXT-B---?X--
-Xo?o-XM-M??B-?--BB-?-E-MoXX---?-X?MBBoX-MX-T-E---X-XEX?-X-XB-X-X?BoMX?-B?MX?|B-o?X-EXB?-T--X-|X?E??X|oMX-MMXXBM-o|o-??TX---?---o??X----|--X---|M-EoXX|X|?B-???MoE-----oBBBBB-?oE--oo-o-MMEXM|?EE----?--
--B--T--|?X-EX?EE-EM?X-XoX--B-oX-o-Mo-?--?o-BXX--X-B-XXBEX-X-M---?X-oT--X?B|-EX-|oX?X-M-o-B-MXMXTM?XX-?X-o|X|B-T--X--E--EXB--?E--B-B?----?--BoB?XXBoM----X?-oMoM-B-ooo-?-BEEXXB-M-?XB---M--oM?o-XX?o-M--
-X-X---X?TBM??--?o--o-MMMX---?oB--To-?MoEM-oXoXM-o?X?---X-X--XoB?---??oE-BB-o--BE---?-EoM?--BXE---E-X-Eo-oXE-EE-EEBXB--B?-B--o--M?XoM?ooX?EoMXo-Mo??o------?--TBo---B-o--B--?|?-X--?B-M---?X--BB?M-X----
--XE-XTXoE-o|?EM-XXMoMB?-?X--M-?oXXo--XXX---E----?o-o|oXoB|--ooXXE?o---ooE-EX-B???X-o--EB-XXM-o-XX-o--X-?|oB-MB??-?XM--?X-E--XX--o?-E-?B-|X-XX-?XXEM--?X-E--X---EB?-X-oXXX----MoXE|oMBX?--XXM--E??---?|v
---?M-X----Bo-ooo?|?EoEBooX-o-M--X-Eo?EB--XBXXo-?-o-?|XX--oT---E?Xoo??XBX-o----?--Eo---?X-XoX-oo-?M---------M----X-oo?-o|-o|-?-??B-?|-XoE---TEB-o-BX--oX-X-X-oXXXX?XM-?--X-EoTXT-?o?M---?o-ME-X-?-EXX|of
-XB?------X----??|-XBM-?|-o-o-oBoXT-M---BXX------?BMXBE---MXMM-E-X--TEo--B--o|?XB----EXo-Xo----MX-?o?BBE--oX----XT-Xo-o-?X--M--EB-X----?BXB--E----T?--T?---o--BXoE-?-?o|--XX----?-?-oXBMB?--?T--?E-?o-of
-?XoX--XEE?X----XMXM---XME?---?XoEX?-?-oE-??oo---?----?X|M----X?XX-E---T?---XoE-M?-MoXXX-XB-X----|?MoX--B-T--oMBEX-B--???B--B--Xooo?o-?--X--??E-?X|MoXE----o-o-X-XB?o--B??X-XBXo-MTX?M--X-Bo?o--XXXo--?f
--ooX-----M----oM---?-XooXETETMo-XX-?---M-??--oX|-o-|--Xo-XB?--o?T?-X-E-?--XoTBXME|M-o-?-XX-----X-----MXX-E|Bo-?X-XM--E-Xo--X-oMBB?X--BX-X-E?B-XB--B?XX-X-?oMXBo--oX--MBB|----?-B-??---MEEXMo?-?X|BXEX-f
---EBMBo-X?MX-M-oX?XM-X-ME-??o--oo?BEBEBB|?X-?BM-?-XoB-M-ooMoXXXBM--B---BBBoXMMB-?B-Xo?--?o-XoMMXo--BX-XMBT----?B-oX-?EooB-M-----Mo-o-XB-?XB-XX-BX?---B-EMo-MooE-M-o-?oB-BT???Xo-B|-X-Xo|?o?-oMX?o?E--Xf
-B--oBoM?-BX-XX?-XE-oE--XMMBB-XM-BX-ooMo?B-BBX--MMoBM-E-??-B-EM--X|--o-B---M-?MEoT?oX-?--?oMBo--XMX----XX--EM-?--BX-?-TXB-X-o-EM-??-M?B?X-?BoXo?-oB?XXo?X-o--E-XBX?ooBE---?-B?E-?oX??XEBXXoX?--??X-?T|?f
mEooMX?X|BB-BBB?-X--XXoEX--XX--XXo-oM-----o--E-oB?X---XX-oBX--E-X-???BX-oMXEE-MoXMXMX-|X-o---X|oM|-BXXE-B-|-XXoM-?oEMXo-BXT-M-o?-E?oT--M---XXXB-M?MXM-oBT-EM--X-M---X?MXB?-?---o---oB|?o?XB---MMoTBEXo-X
XXXX-XXX--X-XXX-XXXX--XXXXXXXXX-XXXXXXXXXXXX--X-XXXXXXX-XX-X--XXXXX-XXXX-XXX-X-XXXXXX-XXXXXX-X--XX--XX-XXXX-XXXXXXXXXXXXXX-X--X-XXXXX--XXXXXXX--XXXXX--XX-XXXXXXXXXXXXX-X-XXXXXXX--XXXXXXXXXXXXX-XX-XX-X
