-M--------B-o------B?-ME--E------E-X-X--o--XE-B---B-B---EME-M-M-EEB?B-B-X----o---?M----B--B--M---XE?------o---?-M-E-------XBMM-XoB--EB?o-?----E--o--X--E--B-------?-----E--B----o--X?---E-o-oX-??-E-B---
---------o-----?-----M---X-------BE------E---X----o----X--------B----M-----oE-oM----XM?-B-----E--B-o-X-M-Mo-X-B-----?--?--EX---X-E----------M---o------B-B-M-?---??-E-oEoX-------o--BE----?---Xo--?-----
--BB--B-E------??------oX---?-E-E-------?---M-----B-E---EB-Bo-------X--o---oE-----E-E------?----B-BooXXo--B-X-X---M---MB--M--X?--EMo-?--------------E-E-?-X--E?--o---X-------B-----oM-----------X-------
--X-o--EM?MX--o---E---oE-M-Xo---o?-X-M-oo-o--??-?M--E---?-BE-?E---o-X-EX---------M--?--M-E-E-?--o-X-B---BM-----M-E--?-X-----B-------o--X----------o----------?----ooB----E--o---o----?oB----?-oo?-?E--o-
----M-M----o----M----M-----MBo----?-------E-ME-?E------?---?oXEMo?----?o-?M------M------M----XB?------X-M-M?o----BEB------X----?--EM--?-X-MM----MM---X--B--E----?--o---oo----oX-BE------E---?------oE---
--BM-M-?--o--o-XoE----o-X----------------?--o-E---M---------M----EM-E---B---o---EBX--X-M---B-B--E------E--?E------E-B-M--B---B--o---M---o--XBB?----?-X---o?---BX-----------E--------o--E-E?----o-B-??X--
-?--------X----X-o-----E-?--EE------E-----------E-EM-oM--?Eo?-M--MBXXX----o-oX-B---M-oX----?--MBo---E-X-M--XB-MMXoo-------E---?o-?o---?-------o-o-?-o---B-oE----o-?-------EE-M---E-M----B-X-B-o--?---M--
--E-X-?MB----B--B---o--B-E--BE----------X-o--M-BM---X-E-----M------o-X---Mo----M-E---MoX--B--E-----B---?---Eo-?--X?-------X---E--E---E-X--------M--M---E-B----B---X--X--Bo-M--EB--E-BoX---XE-o---M----Bv
---o---------o----EX----------------X-XX----MX--o--B---EEXX---EEE--BBo--?B?-EXE--?X-Xo-B--------B-o---o-M--------o--X-----E----B--------?-MB-----BXB-----X--E-?-----------EE----?M--oEoXo-E-EB---E-EX--f
----MM---X-------?---M---BM-B---XXEEBX--?oB-----B-?-X-------?-M------?--o-E?-----o--M?BB??XM--------EM?--X-X-----B---EE?--E-o---o--E--o--o--B--X--X------X-X----B-B----BMB-Bo----?-----M-?---Mo---XXX--f
--X--E---X--B--?-?--o---B--o--B-X-B?--?---?-oX---o-Xo--B-E-X-----M?----X--E-MX--X-XB---oMoX------B-------------o---M-o---oM---oXM----E---M-E-B------oB-MXB-E-----oE-----M----B-----?---M-----?-M------Xf
------E-o--MBEM---M-XX-?--BM---------X----o-X-----oo-o-Bo------oo--------oo----M?E---XX-E--M---------?------?---o---X--XM---B---------E--X---o?--o-M--o----MBM-------??-B-------------X-XM---?----M--EBf
--o----Xoo--B-------X---M-----oM-BEX---B------?-XEEE-X--M------ME--X-oE-B----M----oE--EM?--B-??E---B-?----oEo-----oM--M--oB----oB?-X--M?---------M-----------------EBXE----B-X-M-?--M---?----MB---oE---f
--MM--?--BoE--XX-X-ME---MX---X--------o-M-Eo--E-B----MX-----B-X-o-M-B-?oB----B-B-----B---o-ME-B-EB---B--------E-------E---B---o?-X-X----X--M--?o-?-o-B-XE--E--X-M---?-X-----X----XM??BME---B-M----EBoXof
m------------------------------------------------------------------------------------------------------------------------------------------------------------------------------------------------------X
X-------X----------------X--------------------X-----X----X--X----------X-----X---------X--------X------XX-------------------X-----------X------------------X-X-----------------------------------------X
