-|M--E----X--X---T-M----BTMo--M---X----X-X-----E--B--BM---o----------oE-?---E-X-T----T---------T?o------MMB-?-M----o---|-o-?--||--------?---|----o--|---o----------B-X|-To---o-BoX---o--X-E--M-----|----
--T----T-----M?|T----M-B--B------T-E-|--BX-oT--------T-E---E-E|T-|-M-?--X--|-----|--E---|--E---T-o??----TMT------T----MX-----B|-E--XX----o-------------B--o-T-------E--E-M----Bo--|----ToBE--E-|-T-o----
---B----M-?M------T----B-M--M-----------TB-BTM----o-o--o---o--|XEETX--|-M---E|-TTXX------T-o--------M--|-------X-o---M--MX------T-E?---oM-T-X--------oB?---X-B----|---B---?-oT?M-------o---X-X?-----|X--
----o-E----?-EXMoo---M----B------B-----o-------Bo?-o-E---|--?---?--B|-?---B----o-M-|o---T--?---B----X-B---------E----B--B--|B-X---|-?--E------T-|-B--?|-?-X------oB-------B-B-E--M--?-X--X------B-T-?-?-
--o-?B--o?BEM-ET----?-TX|--ETXT|-o---o-X-X-M--B-M-o-EE-M-oX--|-TB-------------------M----E-E----M-BTM----|-||---T-----T-?oT--M|E-M----o-E-oEB-?-------B---?|-T?---X--??----MX-?-|--B|TX-X--M--?---MT|---
---XX|o?-BT-X-|-E---T--?-------X|-|MMB-XB-?-----o-|-------M---?--X----TT---|--E--E-M-|--T-|T---ETB----??-oX---TE-oT------M---TX?--B-EE--M-||M|---M--||Bo-TB-oB----B---------E--X--X-MoE----?XMB---------
-Bo---E--B-M-----BB-|o|-XB----BX--M---X|X-----XB?--o---T-o-o-MT--|-E--M---o--|MT--M-|----T--E-------ET--E|?-----B---M-----oo-?o--|---|---E-?X----T--M-X---?MM-XEB-BT---o-B--M-E------?-T|-?---M-|---XMT-
----EX-?--E-X-o---XB--E--oXB------X----EXo-oTX-------T-o-?---?---X-?BoT|E-------||--B----TM-------MBo-?-?------------E|-TB----o--o--E----o?---B|o-|----E--T|-TE--?---?-?-----------X-M-o--EM-X-E-------v
-B-----X----o-XT----T-oMBE----T-o---|---o--T--o?---TB----X--oE----M--------XB?------o-?|o|--B-------?------M|-|---o--|---X----M---X---XE--?Mo|M--B|-?----B-----------X---|B----M------o------BM-M-E---Mf
-----T--?-B-E----M-|---?-Xo?-o---?B-----oM-o-ToX-------?--M-|---?---?-----M--|-----T---M-----|----o---XM-o------TM?----?-T--X--E---MX-MoX-XT--TXE-EB--X---?-E----------T-?---X-B----|?-EM---?-o|o-?-ETXf
-|--EMM----------T|---E-X------E|----M-X------T-----Eo----M--?--|---|E----EE---------oB-oEE--M--------XX----EEM------?----------?-|--|M|---T--T---Xo----?-o-|------ET--E-o-Mo-?-----E--------Xo-X-X|---f
---M--X----X---|X--??-XTo----?--BX-----E---?---|-------?------|----E-?X-----X|-B?-E--X--T--M-EM|-TTo-B--E|--?X-T---|-----|-M--T-TT------B-T--E----T----X--B---BT---o----B---E------o--B-|----------o--?f
----oXT----------EB--|?-T-B------E--M--|-o---B-BT--TTM-E-----E--M-------------|-|-?ME-B--?----E-B-----T-o-T-M-|-oB-M-------T|ET-E-X-|M----X-------?T---B?-------M--B|-TM-EM---|--o-T---M--MX-oX-|---B-Xf
-----------------------X?----M---T---o--o--X--------TX--X?------B--|-T-B-B--B|---oE-o-----X-E--?----?o|---E--T---TB----o--------oT-?-M-?TT---------|E------|XB--?--BM|?--T---oX--------E----X-|----B-ETf
m-?-----E-M---E--EB-XMM--X--------M|-E------E-o-----X?|T--XM--B------T-------T--X--B-M------?--T-X-----MT|---T-oME---------ET-XT|--M---|----E-||XX--X-Bo-B-oX--B-|--|---?-----------B|?E|------X-----T-X
X------X----------------X-X--X----------X------X-------X-----X------------------X-----------X----------XX---------X----------------------------------XX---X-----X-----------------X--------------------X
