----XXT--TTo-oT-X-MBTToTTMT-T-XT--X-X|T-|TToT-X---Mo?|XT--BTT--TTo--??---?oTMB|-T-o-TMBT-o?oTXoTE-EXM-?Xo-oB--T-?--Eo--T---?-TT---o-----XB-|E-T--BBX--T-XEoTT--oo-TBXX----o---M-EETTT--T-B-ET?X--E?oX?X-
--M-XXX-EXE-XXEX--E--o--oToET-|B--T-M-TT-T-TMBXM--B-T-ET?T--BMoT-|?--M-TB--?BoE-B-X--TB-T|?MT---TEMoEoo-o?T-TTE-?B-XX?XX?-T?|---T?XE-T---M-TET-T-?T-?TToo-BT-EET-o|oTB??M|B--XTX---XT-T----B?oXo|o--EXM-
--?-EoXToT-Eooo-o-Eo?-o----?-XoB-XT-BXM-E--o-M-E-M?-|--T?BXXXTXo--TB-M---oBX?TTo--|--o?-T-B--|-X-T-M?XXB-X-TXTE-BTBTTE|X?E-MBE-TEX-ET-XEoT--?BTT-X?MTT-XXoTXBX-?M-TT-XMTTE-?B--T|-|-XEXE-ToB-TX--X-??MX-
--?-TB-Xo-X-X---TTT-BT?XE---TTX|X--EM------X--TXXEM-X-o-B|T-T-B?o-XT-?-o-oMEM--B?TXX-T---oX-o-TTT--T?XTX-TB-XM---|T-?E--?X--M-X-To-oXT-XT--T-TT?|?----TX-X-To-T|X-BXT??X-T?-BT?XoEX-TX?-M-oTE--T--?-B---
-oo--TB-TBBEB--?-X-|?METXTBo|--o----?oETX--E---M-|EXET-X-E--TBoXTToBMX--??-EoXT?-?--?---XTXXoTEXXXTTE?--T-o-oTo-BBT-TB------X???--T-?-TTTo--o---TXTo-TXXB-?-?--X-|?o--M-TTBET--oEX--X-oB|-T-|o-ooX------
-TBB-B-T-TT--E?-EEo--X--T-|XoXBT-oXE?oB---E-oTBB-TX--??-oTTo?|-MXXTTXoT-?T---TooTTT-oE|TM-Moo-------oT?BB-|oT---B-|---TX-?---ToT?oTE-TBEoo----BXT?-o|----To--T-oo-T-XX?X-Mo-XT?X--T--M--oT-o-?oTXE---oo-
----TB-E-o--|-?T-B?B-|TM?E-T---?TETo-TTE-o--o-B--EM-XTT?-Bo-TXBT|-oo-XTo-B-o-Eo--BB--?E-T-----XMX--XXTT-----BToXETX-T-?TMTTE-ooT--?T-TT-MB--TM--ET--T?TBMoTBoMTX--E-T-oTXTB?-X-BMB-MM--ToTTE-E------oTX-
--XEX-o?o?--BT?-B-T--TBM---XT-Mo-T-BT-oTT-EXT?EX?E-T-T?--E-X-To--E--?-X|X?EXM|EXT?o?oEBTMT--?T-M-MTXXX-ooX?M?-?-|M-BB-MBT-BETTM----E?E?TT-TT-o-o--EXoB?-X|--B---o-BMo--T?X--o-T??X--MBT??----TEoTET-BoXv
-?-E?|-T--X?TBo---B-XT?-B--ETT?-TT-T--T--T--TTXo--ToTX----TX?T-TXEX-|XT-TMMoT-----XT-TBB--oX--MoBX-BoXM?MT---oE-oT-XE-X--BX--?--BT-X--oBo--TT-|T-oTEM-T?TM-|-----BTTXT----oB??TB-ET--T?BMT|o-XE|oT-B|T-f
-X--EB-TM-o-M|-Xo|TBTT-oB?o-TMET-?-X-M?-?M-X|?MBTXM---T----MXMo?|-TB-oToX-XTXEEXXMT---?M-o--oMB--M|o--TB|-TE?-TTT?E-TETM-o|-T-|--?TXoo-TTTM-MTT-MT?oT-ToToXEoE|T------T?E-?----B-E-B-T-M--o|Too-ToM-X--f
-o-|TT----To-oo-?-T?-T??T?oT-?EM?-X-XTX-T-TTT-M-B--TTT-TX--?MTE-?--MM-o--ooT--X?o?BXTXToo-MBT|XMo---o--E|?TXT--EE?TXT-o?-TT-oXo--ToB|-TXM|-oT-MT?TT??-ToBT-E-??-TT-T-?--T|-T--XX-ET-EoT-X-?-T---o|-T-T-f
---B-XTB-X---X|-T-X-XE-B-?X--E?-B-T--|ooXTX|-TXMX-----oT-o|-EoE--MTo-T-EoXo--BT?XMoo--T|?MM-?|XX-ooE-oBoTE-|X--oXTT-oMTX--o-TM-?T?oX--?--ooTE-TB-o-T--BT-TM-TTBXT--|?-?o?|T?-T-MXoXTo-B--oMEM-?T?XT-M|Tf
-XMM--X?E--XoB?--BoB?-o-EBTB-?-B-??--XMM-o-MoBBX?---X-X--BXB?X-BBoM?XB-EB---oTXBXXM-XBE-TX-?XX-BT--B-XXMM--BX-o-E--XBBBB|ooX-X?-MB--B-?X-B?-X-ooX?-XX?-|BX---|--T?EoTXB-?-??B-?B----?--XB-|Eo-XXXE?EB-Bf
-BoBM-XEX--B-BEBME?--XoXBXEX?oXoX-XX?-o-XXX-??B--?-X-XMMX--B-TB--M-Bo?o---?---E-----B-?TX--M-o-?BM?--M|ToX-?X-BB-MoT--oXXB-?oBoBXM---B-?BXXoBB-o-XX-M--M---EMX?X--B?--M-Mo-E?|E?oXooM-M?XBEE?B--To?-??|f
mX-----BX-B-|?|-BBo|?-XXBB-XBX-B--oMXB?o-M-MX-BBoBE?----EBX-?Bo-MBEB-Xo?BooBEMo-o?-oM?oXooBXo-X-|ooB-?|-B----E-B?-|B--EX?XB-?B?-BB?X-oBX-ooB--oM?X-|X-X--XB??XoE??oo--M--XM-B-X-?ooBMXM-XX---X-oT----X-X
XXXXXXXXX----XXXXXXX-XXX-X-X-XXXXX-XXXXXXXXX-XXX-XXXXXX-XXXXX-XXXXX-X-XXXXXXXXXXXXX--X-XXXXXXXXXXXXXXXXX-XXXX-XXXXXXXXXXX-XXXXX-XXXXX-XXXX-XXXXXXXXXXXX-XXXX-XXXXXX--X-XXX-X-XXXXXXXX-XXX-XXX-XX-XXXXXXX
