--M-----MB---o--X--M--XEM----E-?-M-Xo-Bo---XE----B----?-E-M-----X-?--XE-----Bo---X--E----?E--X------oB--X----ME----------Xo-----?----EEE-B----B-B--X-B-?X-BBE-------?-------X---MooB?----B------------M-
-E-B--E-XM--EX?--M--------MX--Eo--XE?------M-B-M------o---M------X-MB-B---B-EMEo----?-MX---B-o---?M-?-E?--o-M-B----B--?o--E--?---oB--B-?----M--?Xo?----B?o---o-----B-----o---E--X-M--E--?-X???------?---
-ME---B?-?---MX-EB----?----B-o------?---?-----o--E--B-BM------M----M--E-----E--o------EM----?-oM-M----X--oE??-----------oBX------B---X--X---B---E------EB-o---?XEB--------E--?X-X-M-?B----Mo----??------
-----E-EB---EB-----?-E----oE--E-X---B---X-?B--M--EEB----X----?oX---EEEM--?M--o-o---B---?--?-M-------E--?-E---??-----?--X-EX---EM-BEM-XM------M-o--o-o--?--------M----ooM-M---------M--E--X-B?---B-B-----
-M--E-B----M------o--X-E---B?-----E-B--------?XX?---?--BB-o--M---o-E---?---MBX----oXo---Eo-oM----B-EMoX--o------XM------?------EE----Bo-M--E---X------?--?----XBEE---M---Mo--??---XM---M------B-----M-X-
-----X-?-o-?-EM?-Eo?E-EBEE-----EE---M--BB-?-??E-E-XX-----X--BX--------EX--BB-oE----?-M---o--BEMo---BX---X--X?-M---o-o--E?-X---?-?-XX--B--M-?-X-XMM-o-M--EM---M-o---Mo----o--X--M---B-oB---X-?BM-X-?o-B--
-E?o--E----XXM?------BoEXB---?-B-X-oX---E-E--oo-----E--------E-------------------X?-oXBXMX--B-Mo---?----X-o-o?Xo-----o------M---ME-M?-----B--E----XX----------?--?-?M?B--?MX--------?o--?-BX---------B--
-B-E--X-E?---o--X---X-E-?---------Xo----------B--oM---E-X-Mo----E-E-B-oX----------X-o-E-?---B----MoE--M-------?-B--?--M-X-BXX------?-X??-X-M-B--B-?-B----------E--XB-BX--MB---E---?-E--ME--EM---o---E?-v
-E----?M--B----BM---E-XMXB-M-B---X-------B------M-E----------?-----?o-oX--B----X---X--oM---o?--E-EB-o?--EM----M---XE---E-X----EM---B---?-BM---oM-M-X--B-X?------o---?-o?-o--o-X-B-X-BM-B??-X-----?X-MEBf
--o-XEoX-----MEM------M---B---------XBMo-XB----BME----EB--X-------?B--B---o-o-----Eo-------M-B----?XB-?X-E-B--oEE--XBo-o-B-----o----E---XB-?-------?E--MX--BB-M?---?-?----E-------??-??---E--------o---f
-o-?-?-E?--X-B?--MB---E-----M------?EEXMo---oB------o-M-E?------EB------------B--oEE-----E-?----oB-----M---o-----B--X?-o------E-E-o------o--B--o-?-oM-EX--M-EoE-----MX-?---?--oB--X----?--B------E-XMM-f
------X-o-o-----MB-B---ooo----o----?ME----------?MBoB--X---M---B-E---E-------M---o----?---X--o-Eo?B-M---?-M--?--------EM--o--E-M---?-oE--E------------?EXooB-X-X----E--BMB-E?--?o-X---------B-----M-B--f
---------XM--E?------B---?--E-----M------o---?M---MX-B--E?X----X-XBX--?-o----M-BB---E---o-?---XEooB---Mo--X-X?----Xo--B--------E?BEo-M-E--E-X-----B--M-E-BMB?-BE-BX---B-EE------------------BE---o---M?f
---BB--?B----?M----------Mo-B---B--oB-----E---X--B--?B-E--EB---Bo-------MX-----------?--B--o--------o-B-X-XB------M-?-?oM-o---X--M--M-?-o-?o--BEo-B-??----oMo-----X?-E------------oE-MBM--E---X?--X--o-f
m------------------------------------------------------------------------------------------------------------------------------------------------------------------------------------------------------X
X----------X------------------X----------------------------------X-----X-X-------X---------------------X----------------X-----------------------------X--------------------X------------X-X------------X
