--------------X----o---?M--BM?------?---M----EX-------------------Xo----X---M----B--------------------------M-----------------------------X-----o--------X----------B--EBo--------------XM--?------o-B--
------E-B---------------?--E--B-E----------o---o--?------M-----E-------------X-X---?--X---X-----o------B------o-E-------?--------B---------?---------o--o?--?B-X---------------o------------------------
---?--------E-------?---?------M--------?----------------------?E------------------o----------?---------------------------o-----B--E-?-o--------------------?--------B----------------------------------
-------------E?--Xo-------------?----------X--o--?-------------------E-------B--------------------?-------------o---X--o-----E--o-E-o--------------B-?---B-E-----?-Xo--?-------E----E-----?---E-E-------
------BX-----M---?---------?-----------?---o-----------??o-----o-------oM------o--E-X---X---------B-----B----------------B----------------------------MoX-?--o------X----E-----------------?B--------?--
------E------E----------X---B----?B---E--o--------o-X---------o-Xo---o---o-E----------o--------o--------o-------------o------?--X-X-------------------M------X-o---------------B------o-----Xo?---------
----------X--------------E-----------?----B----------X----------------------------MX--?---------B-o----B-------EE--?-------o----------B---------------------------------oB-o------o---------------o--M--
---------o--M-------------MB----------o-o--o------------o-B---------M-----XX----------X-?----B----------------------------------------------?M--M--B------o--------------B----------E----E-------------v
-o---EoE--X-B------o-----------------?-----?------E------B-----M---------------------?------------------------X----------------------------?-------o----B-----o----BX---------------------------X------f
---o--?-----X--------------------o-----M---o----------oE--?-X------X--------E------E---o---------------o-XM-X----X---------M-------o--XB---X--------B---------M-M---------------Xoo--------------------f
------?------o--X---------X----------X----o-X--o-?----X----B?-?---E---------M-----M-?-----X------------X------BE----o-----o---?---o-------o-------B?B-BB-----------?--------------o--B---?--------?----f
-----------o--------?X-B-------------?----X--------BX--B-----------------M----------------o-------o--------M---------X-------------X-------B-X?-M-----------X----M-------------o------?B------ME-X-----f
------T--------X|XT--------oX-o?-X-XT-T-|BToX---X--?M-XX-oE--MBM-?--XEooB-o--X-?--Mo----?--------T---------T-EX--E----E-----|B-E-?--?-B-----E?---BEo--B----?-----?--oB-----|---T---|X-BX---?-TT--T-----f
------MoETTB-BXM--|B--X--T--T--T-E--X-o?------T?TM-?-XE-|---?MX-oEM--o-----o-B?--T---B|TTT?T------BB----?-B-o--BM-B---|----X-E--o--------oo---X?-T-T?TB----?-o-----?E--T-B-E-------E|--??------X--EXMoEf
m--------|-----B-o-?-X-----T---oB-BX-TT---E-?---T-oX--|---?X---X--o--M------X?-T-ToE--oTE-ToBE--B-MM----T----XM|--B---------T-X-E---o-?-|-T--E--T---X-o--|--M---MMoT?EBT--X---X-TTBT-BT-X?-TT--TX?-X-T-X
XXX-XXXXXXXXXXXXXXXXXXXXX-XXX-XXXX-XXX-XXXXXXX--XXXXXXXXX-XXXXXXXXXXXXXX-X-XXXXXXXXXXXXXXX--XX-XXXXXXXXXXXXX-XXXX--XXXXXXX--X-XXXXX-XXX-X-XXXXX-XXXXXXXX-XXXXXXXXXXXXXXXXXX-X-XXXXXXXXXXXXXXXXXXX--XXXXX
