-oB----XXX-XXM-X--Xo?X-E-o|M--X-MBoo-BB?|----oB-X?XX---|?--X-X---??-?o??Xo?B--EoX?EoE-?-XXBM?BXX?--BB-B-E?-MXM-BBoB--E-MoE-o-ET---T-o|XB-EE-TBXE-M?--Bo?-?-?-o-X-M-B|-X||XB?XX|XE-B-MM--B-T?---?X--Eo?B-
-X?-XMX?----?Boooo-E-oE-ooX-o--oEXXX?MX?TX--BB--oooBM--MoB----EEoBXoE--?--XX----Bo-?M-M-?---XTM-|-oM---?X--BoEo-MXX-X-?oX?----o|-oT-?--XX??BX--B-X--Xo-?XX?XB-?EMB?MX---XMXoMoMMo|BX-?ooBB-o-?---X-T-B--
------Xo-X--B---?-?EX-o??-E--o?--??--E?-?|--XM---BX--oB-o---?---o-??Eo---BX--o-o-X-oE---EoX-oMM-XBo---TooM-oX--X?XX-BEXTE-XB-E-o-X---ooTXXo-MEB-oM---oB--?Bo-T?o-M?E--BX-X?--XX-oB-M--B-B-o-----BM|--T--
---X-?o-BE-T--?oBEMXX--X--?oXM----o?Xo-----Xo-----E--X-B-ooo-o?MB-X??X?E?Eo-XMoE?|-BXX-oE-oo-?X?-|B-T-MMB?EM-BXX?---BoXoMEXMBooX-X---oEB-XB-o--E----?-o-M?-TX-BBT--??oXXM--XEX??|X---X--o-Xo?o-XT--XXX--
--X-------XXB-E-o-BMXB-X?T-B-XoEXX-|MoB?-?B-X?--o--EMoXMX????Mo-ooM-o--XoooX-|o--E--XMMMo--o-EoM---X???M-XB-?|--o?--M?XoX--o?Mo-o-E?o-o-oMM-oX---X-B-X-MXXM-?X-EX----X---XMBB--MEX------oo-E?X-BEE??X---
-?MXB-Too-X-BoETX-oXX?Xo-?MoEBE?M-?M-?B-XB-XBX?-M-EoX???--X?XX-?-X-E?EM-XoB-|XM-oo-?BXMX-?-??B-EE?-?--E----?|B------E--oEo---o??---oo?--E---XoM|X--X---XE--oX-o-EX-o?B-o??-|EB-X?-M?--XX--|o?X??X?--X?--
-BBXoXXBoE--EM--?-o-ooBX--XX-T-BBoX---?ooTXTXBo-X--??-M?|M|o?o-ME--XoB---?-X------?-XXXo-B?BX--?|TX--ME-MXBoE?o-Xo?oo?-?|X--B--M-------B|XEX---EB---?--X?BX-XXX-X-?-|B-MTE-BXMXMMM?oo-?XB-XE?MEoE-ET-Xo-
------Xo?B--?|o?---EE-?oX-?-XoEX??E-XEoo---M--BBoMMo----TB?o-oXXB-?o-MX?--M-X?X-oo---?-BX--M?oMo-oX?-B-X--?B?-XEB?XEXMXoEEX-?XTE--T?Mo??-EM-XoX--oXX--XEE-BXoBEBo-XXo-?--E?-BMEE--|---X--Bo-ooo?X-o-Xo-v
-?Xo-EB--EBB|BTTB-T-?BX-M---M----oEE---|-X?-o--X--?X-XoX-?XM-XX-ooX--ooEBMM-B--M-BBM---Mo--o-XMEXo?---X-oMX-?-BX-EXE?-B?oX-o-------o----XX--oEoB-E-o--?oXMM-EX-X--Xo-BEX-XX-MTX-?MM--?--B?-|B?--EX-X|-Xf
-oX?Bo-X?o?-XM?o--X-E???-EX-o?XMB--?-Mo-M?oMo-B?XM?-Mo-X-X--E-?XB|-M-B-Xoo?X-E------o-XEMX-?oEEE?---oMBMB-?o-?-BTXo--?ET??-?X--EoXo-X-Mo-E-o--?-E--B-M-Xo-X?o?oXBX-?-XT-oX-|XE---oMX-X-?X---XEEXXoX-M--f
-oXXX-T?B?M--X?BB-EXoB--T--oB-?MEX??X-B-X?-EE|-E--MBBoXo--E-?ooB-BEXX-o---X?oMEB---X--BX-E|-T--Xo?-o-o--?o-XMo?o-?-X---TX-o?-X-|XM-X-B--BB-oX?--BoB|X--|--Eoo-?T-B-M??oMEoX-??BX--B--M-XoB-----o-MXoMo-f
--E--oT--M?--o?XX-E?-o-oX-?--?---M?X--|-BX?--B-TXXXX-M--oooE-B---X-X---XoX?----XX-oE-oM-B-E--BXo--o-B---o-?-XoEB----XMBEXoX--oMXB--B--o--E--BXoEoE?-?-Xoo--??-?MB--BE??---?--X-B-EX???--E?--o????-E-|XXf
-o-E?-BX-Bo-oBXBM-M-B??XXX--EEoMo---EE--XX?TXEX-?-BXBB--EBoXX-XEXo|B?-EBo??E?EM---MBoo-BXMX-XXMX-oX---BE-?BE-XMBT-T?oX--?MXBo?-|--XMXXTBBB?o-?ooEEX---BoMB--?E-E---B-BT-??-B--TEB-o?-MTMX?E?E?XoX--X-?-f
--XXB-|X--??M--TB-XBBo-MoBX?MM--X?oBMoB-B-MoX--MMT--B---E-E-?EX|B-o--Xo?B-----X--B-B?MBXB-o-ooE?B|-M----BE-??X?EEoX-X-T-o-o-EX|E?-X-oXX-EMoX---??o-EoXX--X--B?oXX-oXo?-B?XB-?T-BBXBXBBTMXM|?--?--?--?-Tf
m--B|-XXXXX--XX---X-X-B-oB--B?X-Mo-oT?--oE|XBXX---Eo?XBo---?MB-|-?BoBE-oX-XEE-B??---B-XBXE?M--X--o?|-???E-ooMBM?B-B?METo--BMoEoM-X---BooXXXB?MBX?B-M?-XBooB-B?--?--XXBX-T-Bo|To-X-E--MM--MB?--MoBB-M-|XX
XXXXXXXXXXXXX-XXXXXXXXXXX-XXXXX-XXXXXXX-XX--XXX-XXXXX--XXXXXXXXXXXXXXXXXXXXX-XXXX--XXXXXXX-XX-X-X-XXXX-XXXX-XX-XXXXXXXXXXXXXXXXXXXXXXXX-XXXXXXXXXXXXXXXX--XXXXXXXXXX---XXXX--XX-XXX-XXX-XXX---XXX-XXXX-X
