----Xo----------?--Bo------------------o-M?BX-o----o--o-------E---X-----------E--?----------------------B---------B--B------M--X----B-------Eo-----------X--X-----------------X----------------E----?---
-----------------EX--?XX-E-----E----------------E--oX---X----o--o------------M--B-----------------M?--E----B---oB-X-E--------------------B----o-E-------------?------X-o-------?o-B-------?--------o----
-----------o--------------X----------------X---------------------??--X---B--------X-------------M------------------------------Bo---------o-----X-------------B?E-B-------o-M-E-------?--o--------------
-E---X------M---X-----?--------------X-?----------B-----------?----E---------?---------------------B--?--------X--------?---------------------------B----------o---------X-----M------------------X-----
----------E----?-------------B------------?-o--------------Mo--M---?------X-X-o-----oB---X-----------------------------------------X-----------------------?X-------------o---oo------B-o---X---oE--o-?-
--M---------B-M--------X--E-------X---o----------o?---------X---?--?--?------XX----o----------------B-------B?--X?---?-------------E--X--X-------------------o----?--------X-----X-------E----M---B-----
------o-B-X-B-----?-BB-------------oBB----------o?--------B----------?----o-------------X-BEB--------X-?o------E--o----o------o-oX-----------------X--o--o--------XB--X-----------B------------------XX-
--oM-o-M--------------B-B----E---X-------M--X------?o----------------oM------------o--------E--Bo-----E----M----------------X----oo----------?-----------------?--------X-----o--?-----o---------------v
--------B------M-----------X---X---------B----------o-E--X-------?--XB--?-X------------------------------oo----------B-o--B--------o--B----------o----B--XM----------M--B-----o---------o-B---o--X-----f
---------oo--X------------------M---o---EE---?--------?-X-B----E-----M-------o----------------Xo---E---?---?---o---X-------?--------------B------?-----------------------------B-----M-Xoo---o----E----f
-B----------X-XB---------?---------------------X-M--------Mo----------oE-o--?-------------X-o--------BE-----------------oo-------X------oX--B---------M----E---------?----------------o--?-------B-----f
------------M-X--B-----?---------X-------?----Mo-----------------------B---B----------M-----?-----------o-------------X-------X-----o-----?--------E---oo-----------------X--?------X------M----MBM?---f
--------|-X-M-X-------T----?--?----o-T-?--X-ET------XX--T-B?------o-?-ToMXo--o---B-----T-B-o-X|o?-----XB----|-o-----EEB--B--Bo-o?---T?------X---o------E---E----|--E-T--|T----?|-XBT-o-X--T|-X----B----f
-----oX----o---B--|T-o--M-T--?-X--T-TToT----M--T?---T---o?-----?T---|--To----|-TBT--T--M---B--oX-----B-----TX-MX---X|--T---ET-oTM--M-?-o---T--B---oBoB-?|--B-X?-|B-T-------B-T?B---B-T-----T-T--X-----of
m-----oBo|-T-B?-TT-E-o------T--T-X-T------M-----M-T--?---?--|?X-E-------------------M----T--XT-TT----?---oB--oXT-----E?X--EEM---E--oTE-B-X--o------------o---XXE-T----T-E---TB-o|E--EM---o---E--ET--B--X
XX-XXXXX-XXXX-XXX-XXXXXXXXXXXXXX-XX-X-XXXXXX-XXXX-XXXXXX-XXX--X-X-XXXXXX-XX-XXXXX-XXXXXXXXXXXXXXXXXXX---X-XXXXXX-XXXXX-XXXXXXXXXXXXXXXXX-X-XXXXXXX-XXXX-XXX-XXXXX-XXX--XXXXXXXXX-X-XXX-XXXXX-XXXXXX-X-XX
