--?M?ooX-B?E-Mo-ME|XMM-E??-X-X?oM--E-oM-X?o--X?X?E|BT-B?oXTo-oToB-M-X--?-X---X---o--X-?-|o-Mo?-MM-EB--B?-o--X-|-?-M-o-??--?oEEME?-XTB-BE-EoB---?o-o??XE-?--MoM?BBo-B-X-B?X-?X????-M-X?o---|--EEX-XM-o-X-
--?-XB-?---?-X-B-----TE---?----B--BMXoE-oo--E-BXXE-XBMoB-XB?MEo?XX-X---oM?M-M-EB?o-XBBXXXXX--?-X--E?-To??MB-?----BEBo--o--X?M-XEo--?X-oXXBX-?-X--oXB?o-B--?|o??E--?ooB--B-|o-o--XT--B?--X?oME----?o-o?--
-??M-o--ME---Xo-X---T--Eo--?-o-B-o?X--M-B-X|X-B--B--Bo?T?o-?MX-BB-X--?-oX?-oX-|M-XBoo-oMM----MEB?-?----XXBo---?Bo-X--X?|ToBBX?-XX-?X?ToX-Eo----M-?Eo?--?B-oT--MX--BXoX-XM-o-o--oo-----?-X-B-|BoXXXE-----
-X-XoMEM--X-Bo-?EM---M--oXo--BT---B-X?-MoMMEB?oo-Xo|ME--?X--XX----XM-X?-M?---|-B|o-X--?TX|o-o--X-?E--MX-?--TTXE-XE-?X---X-o?Eo---X-?XooXBM-MooM-|-XM----E?B?B--B-?-METo-B-EX|XE---X-?XBX-X?X-?o?X-oE?XX-
-o-o-X?oMB--XB-X|-?B?X-X|B-T-XXM?X---|--MoM---E-T--Xo---Eo?--?o-?M-X---?--?M-o-?-o--o-M-X-E-|Mo--X--|-X?--M--X-X-X?|-?--M-B--BMX-----X??--MoX-BBX|XoX--X??--X-?-oB--M-oXXB|X|XE-?-??-o-oXBEE-B?o-oMB?Mo-
-EB-oB--o-oX-?-oo--XoXXBXo-X--M|?oXB--Xo--E--M-B---?---B---BoX-B-X?BTX-E---X?Mo?B-B-XEo?----EX-oX--|M-o--B-X|-X|o?X-BX---|B??--X?BX?|-X------X-E?---XMM-??XX-B---?-Xo-X---oo-TX-BXoM-oo-M----o-MX---X-?-
-Xo-M-X-EX?X-oMBB--oo--|M-??-oE?-o--?-o-oXB-oEXX---BEBX?Eo?X---MB-X-oTBo-E---T?Boo?--MXMB?-XXX-B--BBooXM?--E-Bo-M--B-?E-XX--B-ooBM-X-------BM-Eo?E-X-o-MT?o?B-MTBB|?-E-?Mo--T-BBE-M---o?-?o-o?BXEX-MBEX-
--oM-?-oo??MB---|-XoMBXoB?---?--MX-?-?X-BX-|--BMMX|---|B-o|--MX?EXB-Bo--o?-M-BM?E---ETXM-Bo-XEB-EBX-To?X--E--o-E-oTX|B-????--X?oB?-?XX?|?EX-XX---oo?-BX-EEo-X-XX-E--|B----BoXE-BE-X?M-X?-o--B--oXEX?X-Bv
-|XB-X-o----X?-X??-XoXTMXXX?MTo|-?-o|M?---X-o?--XEBo|??-?---o?-o-E-|--o-?-TX---oBB-X-?-MoEXo?-BoMXoM?-?E?-B-E?--ooX---E-B-M-?-?-BBX-o-oXo??MX-MEoMXEMo-----B--X-B-BX-??X---XMX-X-|-EM?MoX-?BBX-?-BB-|B-f
---XB--BXMX?o-B-oo-??X--B--X-oXM-X-XE--M-B??o-X--M-X-E---XX-?MM----?X-BX-E-BEo?---T--Bo|M-X|--o-X-X--B-MM?oEBBM?---X--B--MX-EX-ooM-X-------Mo-M?TM?To|-M--?--XE--?XB--XXBo-?o?B??X-TBo--XTo?--MXXo----Xf
-o--o?X?MXB-MTXXo?--oMXB--X?-??M-X|XoB--X?MB-X-|--oEBXBX?o----X-o-----T---T-E--?---M?X?Mo-M?---MX?Xo---MMo-?M--X???M?E----X|o?X-M-?--Bo-M?Bo--|-XX|M-oo--?-X?o--BB-o-Mo-X?BB?XX?X--B?XT-MM-XBB---BXB--Ef
-B-M?|BXXoXX-?B?X-?-E-XE-EoEX--XMMBXX-----o-o-oEXE-?-?-TX--EXXo-??-o?--oM--ooE?--?E-X?X-?-XBoB-ETE--B-|----TEE?XoX-?B-X--XXXBE-|X-X?-M-???Xo--BEXo--B?T?-?oX---o?-X--MX---o?-EXEBBBBT-oBoo?Xo--?o-oX-TTf
--B---E---oMBXXBoX-X|oBo-?Eo?o-oMXX?o--o-|XTM----X-M-oEB?E-?-o?XE-oMB----X-XoBMo---?M?oE--E?-X-B-XX-o-BB-B-o--M?-X-B??--EM-BoB-M-EMXBBXB-XXBXX---EB---?X----MX-X?E?--?oBXB-BXBMX?-BXo|--o?M-B--MBM--M-of
-----?EX?--BM-MB-BM-?X-ME--EB-M-MXXM--oM?MoB-B?-?Bo--Bo-MB-?--XBBXoXMMBX?-M-o-M-BB----o?--o-B-X-BMXMo--XEX?XB--XMMBB-M?oB-oB-B---|Xo-B-E?B?--X---o?-oE-BM-X-o?ooo?-B?XoX-oMB-M-B-E-X|B-B-BX?o-MB?T?X-oXf
moX--XM---BB--?EX---XMB-M-EB-T-E-B--B-Bo-B|-o--BT-oX-?-o-?-?-X---?o--MT-o-BXEXXM-oB?BXBB|M--X-?-?--B-B-X??o-M??-MXB-M-XoX--oo-o?ET-BM-oX-B-M---X-MXM-----B-BX-?B--?MXX-M-X?oo-X-----?-EoX-BXoX-T-XEBEX-X
XX-XXXXXX-X-XXXXX-X----XXXXXXXXXXX-XXXX-X-XXXXXXXXXXXXXXXXX-XX-XXXX----XXXXXX-XXXX-XX-XX-XX-XXXXXXX-XX--X-XXXXXXXX-XXXXXXX--X-X-XXXXXXXXXX-X-XXXXXX--XX--XXXXXXXXXXXXXXXXXXXX-X--XXX-XXXXXXXX-XXXXXXXX-X
