---|TMM--------oEM--?--------TX--o-?--------------o-MX|MB--|TE-----T-|--|---X-T|----?--M--T--Eo----------|o-BE---?X?T---EE-----T-X--T-----|B--B----To--MoT-----EB-|----B-|----T--EX---o---B?--M-X--TEB?-
---MT------------?----T---EoE--?M----?o-X--o-M------|---?X----BXM-E?-----?-------M-o-oMT--|oo?--X--E-----X-M---B-----|-?-EB-o-----?X----------B-M---T-E--X---T-----X?X--M--XT-|--M----------M-|----E--X-
-----M---M--o-T--X-o--XTB---MTo-----B-|E------X||------------??--E-------oM---------o-----|----M-|-X--E-E-|------B-T---M--T----E------T|BT---?-|--E--B---X-E-------Eo--XM---|----|M--?------M?-B-E|--XX-
----M--|--?B---|---TT-o?--oXEM-T-M--|----?-E---o------BM--BTE---TX-E--BTXM----M-XX--?-X-------X--BX---B---|-------|T-----oX---o-M----B---EM-|-------EX|M-BE-------EB--Bo------|----EM--B------o----M-M--
-----?|X--B-?|---oMB---------|---||-----|----o-------------B----|-------B-?T--T|M-----o-oT--T---E?-TB-X----|M--o--M?-----|EB-EXB-XE-?X-Mo-E-o--|-X---------||-?---T--M-BMME-o|---T-----o-|M--o-E---T-E?-
-MT|MT|-|------o-----o|-MT-M---MXooB-B-------B-X----E-XM----------T--o---X-----MoB?T-E-B-T?--E-|?|-oX----XX-??--------o--------E--XB--X----X-T------M--E---------M------T|----E-E-E----T-----------?----
--B-EB--X-T---M-----B-----BXX--X---M?--B-M----E-EEE---||o-M-M--?---ME-----T-----MX----X-|-X?-?---o---?E--E-E--E----E?T---BEoE---X--?---o-----|-----o---|E-oT?--B---M--E----X------|--o---o---X?-E-X-----
----|?-------o---------------E----T--B--oo--o--oB?o--|-----------X----E-----------B----M-o-?-?---E|M--MB--B-?-------B-|----XX-B---TBXE-X-|--B-|----T--|--?--o--------E|-E-o-----T-T----o--?BoMM-T--EE--v
------T|-B-oXT--?E---B-ME?-B|--o----B?M--o|MoM----E?--|X?-T|---?-T?--B--BB---|--M-oX-XX------?XE-----Mo----?----?T----o-|---M-E--X-B-------BMo?---E-X-??o---------T-T--E-------B-----oMBTB--E|TE-M-BT-Xf
---B--o----BX---X---M---M-------?E---?----M----E-M-T-M-|---E-oM-----MTo-?-----X----X|---|-?M--To--Eo---B-B-?T-Bo?X?--X-M-----B-ME---TE--B--BE--oE--?-T--||?o----XEE--MT--B--------T--E-M--ET----B-o?|Eof
--o-?--------------|?----o|T-|---T|?|--TB----E--?-BE--X--------T?-B--X------?M---?-E-----T--o-T-ET-??-?T-|B-X-----?--?--------B--oo-----?-B--E-----X-----E-----??E?--XM---||----?----Eo-XTo?-----M-----f
--T-T---B-?o?--EB?BX-|M----B|----TE--E-X--?---EM---EXM-?M---MoME-X----MX-Xo-Bo--EBT------B--M?o-T-E------|---oE---M|---X?T-------|E-o---o---|?|?-Bo--?X-----|----|-------TB----B-E-?T-E-------M------E-f
-T?-------M|-----T--E--X---|B-|-M------ME----X?---M----T----?EB------EB---BT---?--|----M?--ET--E--B----Xo---T--o-----o|--T-------------|B--M---M--o-------E-EX--o-??----B--|MBB--??E-------BB----------f
--BTT-|----|--?E-o-------MB----XoB---?----?-XM--T----X----ETBMEM--o--B-|---?----M----------|--M---o---T-B-E-M-------T-----E?E--|-B------o---E?---?MM-----------Xo|-M---o--??-B---MT-M---M----X--?--M---f
m----------T-|-----T-|------o---M?Eo-o----||-E-TBB-EX-o---Eo-----?-X---B--X--XE-----oo----------?-o-T--X--?X-----XX-|------|---?---T---B--------T---X--X-B-o-ooo----------X--B?T|---X-------To----B----X
XXXXXXXXXXXXXXXXXXXXXXXXXXXXXXXXXXXXXXXXXXXXXXXXXXXXXXXXXXXXXXXXXXXXXXXXXXXXXXXXXXXXXXXXXXXXXXXXXXXXXXXXXXXXXXXXXXXXXXXXXXXXXXXXXXXXXXXXXXXXXXXXXXXXXXXXXXXXXXXXXXXXXXXXXXXXXXXXXXXXXXXXXXXXXXXXXXXXXXXX
