------------------o---E--------------------o---?--B---------------o--B--------?--X----?--------B-----XB-------B-X-----------X----------------------------oX-----X-X---------------X----X----X-----------
----XB-----B-----o----------E?-------------------X---o--?---M----o--------o-------B-oo-----------o---o---------o-X-----------X----o-X--------oo-------------X-B------o-o---------o-E------------------?-
----o---------------B-?----------X------------o--?----------B-----------------------oE------------oX-X-----?B------XX--------------------Bo-------o--------------------------------X-B------------------
-------BX-------------------------------X-------------Bo-------------B------o--X----X-----M--E--------------o-------B--E--------------?----Mo?----B------BM-o---MX----?X-----o-----?--------------------
-------------E------E?----------------?---------oE--------E------M-------------X-?-----------------?---------------E-M--o------------------B---------B---------?---o------------------XX-?----X---------
------BX-o-o--?-B-----------X----?---------o---o---?--------X---o-------o?---------M-------X--E---------------------E--------o--?M--------E-------X-------------------------------B-o---?B--------------
--o--------o----M----E------o----------?---o--M----------?-Bo--B-----X---------E-B?---M-o--------------X----B----X----o-B---o---M-------------?----X----------?-----------B-----------------o-----------
-------Xo-------X-------o----X---------------------------o----o---------------o-?------B-?---E-E------o---------------X------X----XB----------X-----o----------------?--------X-M-----M---------------Xv
---------------X-------o-------B--BX----o-o----o----------------------------------o----MX-------M--?-o-------------o---------XE?--o--X--o--------------B--------BoX--------------o-X---E----o----o-B---f
----------------------B---M----E--------E-M--B-------------ME--M----o---?E--o---------------?----X----E-----------X--------E---------------?o--?X?o---X---------?--------M-----X-E---o-----------------f
--------X--B--?MX----o--o---------X--------X---X-X---X-------o?oX--X----------o----------BXX-----o-?---------B------E-o---XX--B-----B--E----X-?---B-o---o--------o-------------------------------------f
------o---X------B----?---------------------------o---E-----------------E-EX---?-----------------M---------------?-Xo-------------E------B--------------------o------------?XX-------M--?--M----------?f
-E-----T----TT--|--T---T-T-?--E-?-T--o-?M-----X-T?----T-?T-X-TEM------EM------XB---?ET-B--o?--B--?-|---T--?--|-?---||-B---TB------TTT-?MB---T-X|----X----T--B--T--oX---T-T-XT----?-----T--o-T-B|----T-Xf
------T--B--?BX--?T--|E----?---T-?X-M---?X-X----X-|-o-?-----?-o--XT--?---|o-BT---X-E-o---T-?--X--B--T---M-E--B------BXTo-To------T-o--To-----X--o-E-------X--M-XB----EB-----M----|XX---B?T------------Tf
m--------------T--T-oMX?-X-M------M-----?--?E-MoT-ETT---T----M--M-X-T-|---X-T---E-T-----T-M-MoX----T-T--B-E--X--To-|?---------|--o---o-----?-E-T-X?E----TXTXB|--?---oB-o-BTT--B--|o--T-----XTE-------B-X
XXXXXXX-XXX-XXXXXXXXXXXXX--XX-XXXXX--XX-X-XXXXXXX--XXXXXXXXXXXXXXXXXXXXXXXXXXXXXXXXXXXXX-XXX-XX-XXXXXXXXXXX-XXXXXXX-XXXXXXXXXXX-XXXXXXXXXXX-XXXXXXXXXX-XX-XX----XXX-XX-XXXXX-XXX--XX-XXXXXXXXX--XX---XXX
