---M--E-----|o-|-----M|-TB--?-----T--E-??X-E-?|-o-oooTT-o------B--M------|---B----BB---B---TT------|-XM?---BX?|Bo--------M--M?X-|---E|X------E----BX|X------EM-B-o-T|-----?o---|T------E--?-----o---B?-T
------B------X--E---X-|--X-o-|---?-oX--BTME---T---?----BB------------|---M--X-Xo--M-----M---------------XE-------------E--X--E-TM?-?X?--B---ME---?-X-M--XE--T-------X----------M|---E--------?-?T-M-----
---E|--?B------T|-M-------X---EE?----X--T-ET---M|-M-TM?--|----E-----oX|TMBMM-----|o-B?-o-MBB|------BTM?X|---E-oT--XB---M-X--oM---?----M------|--------XBBM?---X--MT-E------E----XX-TB-E--T--?-T--TBT----
---Eo?Eo|-T-?Bo|--?TBo-T-E?E-X------o|----------B--MT--X|-------------T?oB--T-|--TM?---T-T----|----|?------------|-------XX--X-------B---B-?-XB?-oT---Mo----XX-|M|?-|--B--oM-o|-------X-T-ME----oT-T--B-
-M-?MBT-oX-X-------X--X----------------E------------M?-X---?-T|-E-B|-B---o----B-T---M----|----??oBB-BTB------EM|?------ME--E------oT?-XEX--oo-?--T-|-B--X--?-|-M-o----M-B--oBo----EM----|----------o----
--M--|MEB---|---BX?XEMo-------MB?--|---------B------------To---M---?X-----EM--E-XM|--------oTE-M--oB--MX-B-B|?M?--B---X--?-------EE|-B----XTX-B-----|--X---TMXM-?------MB-------M-X--MM-----M|--B--|-E--
-B-|--|TETE--B------B--o-XT---XTT------E-|E----TE--TM-XBEB-M-X-----T-XB--?-------TX-X--|-|||--o-M-o--|---Bo|-----E?-X--MT-?----M--To---E--TB--B|?o-----E||----E---o----T---X--B------oB-B--EX------M-B-X
-E---?--??T----|?-------B-----E-o------Xo--|--M--oXX--E---Xo-----|-MX|B--B----M?X--|--T----|?---?---|o----|----X-T---M-E----o-----ET-------B|B-----E----To--|---M?E|--B----E--B-XT-------?E--M-T-TE--T--
-MB------TBT-o-|--B----?-|-TE---B-o-T---?-X--------BM---|B---M---X--X----------?----?-----T----T-B------|-B--o-o-T--ET-M-ET---XX-o--X------------BE--|----?-M------E--E--X-MT--oEE-M------?X----T---M---
--o---BM--E---E-o-----?Bo---X|-?-X------|--oT-B---B-?--E-T------BBMM-T-T|--|-E--------M---M-M---T----X-Mo?--o-M------M----M---T----E-M-oMET|-?---X-----B-oo--B|--o--XB?-?E?|--EM-X----|--E-oM--X--E?--E-
------X-ET---BX--T-B---?o---T----o-X--X-?-?---------X?-------M----X----XoXB--o-E-o?-oBE---EX------B?E-X-E---E--------oE-M---M-E---|?TM|-o--?M---X-BBT----E-|E-------|---|-X?--T|E--X--?----Bo-T--oX-----
-TM--|-B----------Bo--MTX----E-|----BE-E|E-?---M-M--?---o-BoE-B--B--X-TT-----------B--B--?E-MT---Eo-o-E-EX--E----?B-----?--T-B---B------TX-------T----X|----oX---oE-Mo--MB-T------|--E-o-o---|--M-M-M--M
----------B-?--BMMM------oo-------M--|-B-XTB-M|----o-?T---T---E---X--B|M|-----B----E-Mo---|B----Xo-T-?-M--?-Bo--?X-EMMM---|E-B--X-?---E----??-XT--?----?--T-M--E--XM-T---E--X-ET--B--B----B---B-o---|---
-M---|-----|?X|T-X------XETME----|-TM-------MM---??--o----B---BM--X-ME---?---E-X------T------?---oM-------|ET-Eo--oM-|---BBX|BEXE-MBoB---E|----X--o-----|----o----------T?------?-M-|-----M--M---E------
-|--TE|------B-B-o-X|??--o-B---BX-o-|-XE|---o---------?----|---E------?-----X----o-E--?----X---Mo-------o-------o|-B----M-X--T--M-|-|--B----------E-T--T---?T-X-------XB-MM---T-----E|-T-T-E---X-TT--?T|
-XXXXXXXXXXXXXXXXXXXXXXXXXXXXXXXXXXXXXXXXXXXXXXXXXXXXXXXXXXXXXXXXXXXXXXXXXXXXXXXXXXXXXXXXXXXXXXXXXXXXXXXXXXXXXXXXXXXXXXXXXXXXXXXXXXXXXXXXXXXXXXXXXXXXXXXXXXXXXXXXXXXXXXXXXXXXXXXXXXXXXXXXXXXXXXXXXXXXX--
