-E---------B----M-X------------X--B-Bo-------------?-----------------M---------------------ooo----o-----o---o---o----------X-?-o-----X-------?---X---------M-------X---M-------o----------o-------------
------------------o----------oo-X--o-----o---------E?-X--------X-----X--------------------------M----------Mo--X--EM--?-o---------oo---E---------X--------M?X-E----------------o-M------E---------------
------------o-----M---------X-o-----------X-----EE--------------X------o-----X---------------o--------------o----------X---------------o------E------o-----X-------?---------?-M--------B-X-o--BB-------
------?--------------------EM---?---?-B----E--E------BX----B----o------------X-----E----------------o----------------------------M-o-----------X--o?--E---E---E-B-------------------B---?----------M----
-------------------------------?E--M---o---o---------o---X----o-?E--X-o------B-------E----?-o---------X----X----oXM------------------X------------o---------??--------------M---------------X-----M--X--
----------------o---------------------------B-X-----E-----------------X--------------M-------------?-X--o--B-B------B-E-o-------------?------------------o---o-------------X----oo------X-----o---------
----------------------------E---X---------------B---oo---o------------------------X------E---Mo-------E--------o-X--E-------------------X-----B---M-B----B-----------B--M--------o-------X--------------
-----?------M---------X-----B------B---------------?-----o------B---X-M----M-----oXX---o--M---M---------------------------------X-----B-?--------o---M---o---------o-------?---M--X--------------------v
------------o------------------------X-----------X--o--?--XE---------B---B---E--------X--M---o--o--o-----E--------X---X-----------o-------------------------------Bo---E-----------X--o-------------M--f
-----------oo----E------------------------------o------?o--E?--X-----o---?-----B----------M?-X----------------o--------Xo----B-o-------------------X---------?-----oo?-------------E-X-------M------M--f
-------E-EoB--E-----o-----o---------M--?--o---o-------------------B--E--X----o-o---------Bo---E--E-----X--B------------------------------------------------------o-------------X---X---------oo--------f
--?-----X---o----B--?----o---?-----Bo--M---------------E----M-----------BB--------------BB-o-------------M-----oX------X-----o--B?E-E------------oM----------o-X--------------X--------BX-----o---ME---f
-------X-oT-T-T--?-TXT---E-ET-E--MooE--o----XT-E-oBXT-MoET-M-X?--XB--o-E----TX-o-X--B-T-TT--X---T-T--T-XT-X---?-BT-M--TXT-?-XEMBB---T-----------B?-o---T-----EE----B----T------XMo---oM---X--EMT-----o-f
---------B--|-|--oE|||---B--|?-E-------TB-----To-T-X--oT-|-oX-----E--B-X--X-|---------|-||-?|---|EE--|-E|-------E-?---To|-X--------||-T------?---------|--B-----o--X----|EME--M----|--------|--X------|f
m-----|-----|B|----|-|-T-|M-----T-EX-----T--o-|--|-----|o----Eo---ME--------|--o---E--|-||--|-B------|-|||---E-------||B|----?--B--o|-|----B-X-------T||B--------?------------|-E--|-----Eo-|--oET-|o-|X
X-X----XXX--XX-XXXXXXXXX--XXXXXXXXXX--XXXXXXXXXXXXX-X-XXX-XXX---XXXX--XXXXXXX-XXX-XXX-XXXXXXX-XX-XXXXXXXXX-XXX-X-XXXXXXXXXXXX--X-XXXXXXXXX-XXXXXXXXX-XXXXXXXXXX-XX-XX-XXXXXX--X-XXXXX-XXX---XXXX-X-XX-XX
