-B--?--o?-T-E-o----o--o?X-|M------|--X-E?------T--B--o-?---X--|-E-E-oo-M--TE?---|-E--B--?--XXM--EMX-TEE---o-oE------?--B|-----?-?MEB--------MXM--|--X-B-T----oT--|--E|XTX-?-|-----E--XX--MMEM-M-?XM-E---
-E---|----B--?oo?---?-?-EBETM-ETB-E-------o--X----E--B-E--T--|---E----?--TX--?-----?-------oT-------T---|-----X-E-M-?T-E--BX-X------TEoX--X--M-----TEB----E----XooB-B|----E|-B|--E-|-T--?------X-T-Xo-B-
-B----------?T?---M-X-----B------M--??-|?X--o-||B?oBE-----T-----------E-o---------E?------------M---------M---T---X--XB--BB-----T?-o---M------BE--BX---BX-----o------E-M------?-E-------T-M--------??---
---M-------|M-o-??T--B-o--------?MM--|--|----??EoX-B-M?---|X-MoEM--E-------T---M-|----Eo?T---------------M-BX---M---E----------------?X------------?-?---E---T--M-|-o----------M--B-ME----B---T?|-X-B-M-
---TBEBX---oB---XE---|o?--?-M--|--T----EB-M??|-?--------T--------B---------M-----|---E----T---|X?----X?--To?--E-XB-o----X-E-E-BM?-----T-M-o-MBT------M|--M-o-BBBo|---M----X-oo-|-E---B-EoE--?--E-oBX--T-
-------||---|X--------EBXX-------------BB-----o--?---BM-T--X--X--MX-------------E?-----X-X---E|o-----E-------?-?|----MX-BT-----M-B--T--o?---|B-Mo-?--?EM--------o------EE--M--X--|-||---E-XEXBo----M----
-X--TTT-|T---?----M-X----B---?--M--E---M---M?-----M-X--E-|?T-M--T-------E--M-T?TX-T-----T-E-?----|E--|E---?---T--T-T-?TX---o---M?|--|-|-M-------o|---M--X-?TB-oXE--o|-B---E-----|-----E---E-oX|-M-?-B---
------o?XX-----o-M--||-----X-----BB------?----Mo------M---------------M|ET?--BT?-?-------E---M---|o--------T-----B---o-------|-?-T-B--------------?-----TB-o----B?--?oT-MB-----o--M---T--|------|oBTB?|v
--o--o---------XB--------o---T-----X-ooE--o|----------|T--E--X--T---o-M--X-?-----?B-TX-----------M------B------?------B-M--MTE|?---BX-||T-T--?E----ET-o-------B-ME--oT--|-|--E|-?|----T??-B---|---T--T-f
-M--BT-|B-E------------EX|B-?---E--XEo?----ME-T--X-o--E-ME-|-X-ME-----XT----XX-----MXB--------------?--XTX--------?----X--X-|----------------oM-M|-B----M-T-|--E----X------B--T----o----o-Bo-------E|-of
---?--|---B---oo--B?-E-T--?oEB--MB--E-T------X-T--MB-E---E-----X--o---oB|?---X------?--X-|--o-----E-----M---T-EB|-o-T-M-?----|-X-T----T-X-B|?X---M----------|-|-|--oB?--T-B|o-?---------|??-T-----X----f
--E|--M---To-------?--oMB---B---M-X--B----|-E-B|EBB-----X---o-|-XX--E---X-X-?--X---?--EE--XoX-|---|-----X-E--MT------------M--X--XB--o---o----?---|X------------E--TM-M-X-|--?-?o-M--?|B--?-o-?--X--|--f
-----B-E---?-T-----XMB-B--o----X-T?--TX-----ME--M--E---E----E---o----X--o|-|--o--------?---M----?MX-TT----XM--------|---o-------EM-EE-Bo--EEB|----E--B-------T------o----------E--o---|X?M----T-B-BT---f
---X---|-X-TT--?-?T-o------------B--E----E--T------|?-MT--------M---o-X---|-o--?--M---EB----|--X--EE-?------|-oB--BE-------oX--E-------------X---?-?---oXE-XB---B?T-------B-X---B-XMB----M-----|-----Eof
m--o---XM-ooXMEE||----E-----XB-X-EE-X---T---E--oM?-Bo-oE--o-|---?T--E--TE|-M-B--------|B------|--------------EE-B-|------XBM-M--T-o----------B------M-X----E----------BX---M-T-----oX--|M------?-----B?X
XXXXXXXXXXXXXXXXXXXXXXXXXXXXXXXXXXXXXXXXXXXXXXXXXXXXXXXXXXXXXXXXXXXXXXXXXXXXXXXXXXXXXXXXXXXXXXXXXXXXXXXXXXXXXXXXXXXXXXXXXXXXXXXXXXXXXXXXXXXXXXXXXXXXXXXXXXXXXXXXXXXXXXXXXXXXXXXXXXXXXXXXXXXXXXXXXXXXXXXX
