---E--oXBXX-----------E--------------X-o-------o---?----E-------o-o--o-----X--------E--o--------------oo----o------B--X-------------oB---o----o---X------------?-------------------?-----X-B-----E--o---
-----------B---X---------B-------E-------?-X--B--oB?-------------B--------B-----------o--o---------------E?-----B------X----o?--B--------M-----------------o--X-----X----E----------E---X------B--------
-----------M------?E-------------?X-----Xo-------X----X----------------X-------?--X------o----o--M------X--------BM--------------B----X--X-oo-E----------------------X----------M-------X-----?--o------
----------B---------M--o--------M-BE---B--------X?-----E---X-----E--------------------------------B---o----------------M?---E----?-?---------o----------o-o---------o--------X---o-------o--o----X------
-----------------------M-----------Bo------M-M---E-EB----------------B------M---------EE----X------------------Eo--------------o------------------------oM---XoX---------------B-E------X---o-M---------
------EE--o-o-------B---BB----o--------o--oB-------E-?------------E-?------?-M---o--X-------E--------------X-X--------E------------------------o------------B-----ME----?--------------X-----o----------
---Xo---XX-X-----o---------M----o---EEo-----------o------E------M--?-XX----XX?--EE------oM-------o-----E------E-----------------X----X-X-?-------------------?---o-X---X-------Boo------------M----M----
-----------o---?oE---------------M-------------M------X-----------------------X-----X-E--M------B--X--M-----?----X-----------X-----------M-------------------------------------?-----------------------v
--------------------X-----B--ME--------------------------------------------M------------BBX---M-----------------E---X----------X-----X---?----M--------?-o--------------B----?o---B----M------B--------f
------o------o--M-E------------B-----B-X-X------------EMXo---?o-----------M---Bo--o-B-----------------X----X-------------------------------B--o-oo-B----o-------o----X---oM-----X--B-----------o-------f
----B---?---X----M-----------------------?------o--?------------o----X-----------------o-------------X-X-----------------------------?--------X-----XB-B--o---E------o----E------E----B--o-----oB-B----f
-----------Mo---Xo--X----------------?--o--------------------B--------------------o---------------?-----------------BE--B-?-X-oM-?------o-------o---------X----o-----------M-M-----M-----------o--?----f
------B--------o-T-?XX-o-E--E--M------X--o----To-o---T---------T-?-X-BT----B----T-TX---T--XB-----T---o-?------?B?T?-X--MB?-o------T?X---oMo-M-----T--TB---?E---B----o--------T-TT--T----TT--E-----ToXB-f
------------E--E-|E----------MXMT--?-----TTE--|oo-Xo-|E--B?---------BE|XM---------|-T--|--EB--M-X--B-----|-----------?--T-M----o--|----X-----E----|?-B-EE---BT------o------oM-T|-|B|----E|---------X---f
m-------EM?------|------E-------|---|----||-oo|---T--|o--BB-|--------||E|T--------|o|-E|--B-X-------EMX-o|--T---E-T---EXT---------|---XT-----E-o|o-----------|--oo--E---?oE-T-||-|-|-BT?T|-E-?-------B|X
X--XXXXXXXXXXXXXXXXXX-XXXXXXXX-XXXXXXXXXX-XXX-XX-XX-X--XXX-X-XXXXXXXXX-XXX-XXXXX--X-XXXXXX--X--XXXXXXXXXXXXX-XX-XXXX-XXXXXXXXX--X-XXXXXXXXX-X--X-XXXXXXXXXX--XXXXX-XXXXXXXX---XXXX-XX-XX-XX--X-XXXXXXX-X
