-------???----BE-----T--|-X-----|----oX----------o---o-E---?----M--------M|--B---T----M-o--M-M-B--|X-X------XT---BMo---B-?-----?o--o--B--M-------E---oB|---M----B---oX-M-B----?-?M?ToE-T--MT-MoX-X----o-
-E-------|--ooBBX-?M-------o-----o----M----o----T-T--------oo--M-BM-----M---M--MoE-|--o-T--M--------T--M-X-XM-E-M--B--M--X--T-----o-X-----o-------M---|---o----|-----B---E-T---E--|--M?------o-T--o?TB--
---Xo---E---X---M--E-TT--M|TT---TXM---?|--T--M---M-------T----oT---T-M-MX---B-EB-M-XT-----|Bo----o-----||--o-TE----E-B----?--T-X?-------B----?-BE----oo-?XT--?---|-------o-oM--M|B-XT-----X--?T-----?T?-
---o--?T----To--X---|----------o---o-----X-|E------T-M-E--o--XM---E------E---M-|-o?--X-o---X-E--oT---B----E-|||--|-----TB---XE---B-o-------X------------?-oB-T--o|-BEB-ooE-?--oXT--TB--M-------XB-B-----
---M-----T-----B---B--M--B---|-BB-X-TM?--M--X-EoT--o---M-o-|E----------------oB--E?-o?T--------EBX-|--M-?EB-||--BE-|X---EE----?T--E-T------X-o-----X----X-------o---|-----M--E-----o-M---o|MM---E|BX----
----oET-B|-X--------------B-B--BM----o---X-X-----E-E----TX---oMMT--B?---??X-oMM----X-?--T------------X----T----o-E--?M-o-EoM---T--BT------E-?-------oM------TE----?M|--B--B---E-|?T--oBM-|--TT---X------
----B--M-X-oE-B-o-XMX---o--o-M---TX---XT----o--XX--M-M---E-----MoETo------M-EE----BMME-T--?-BB---|-X---o---?-|--E?-----T-----?-T-----M---M---M-T---?-B----M------XEo-MT----B|X--o----M---X--T-T--T----T-
--Xo-------?-----o---M---------M-o-----------?---|M-E-E-?-T-o-E?---B|-o|------o-X--|M---M|--------T---E---M?-----BBX----E----|-B--E--T-M--|---X-XT-----o-o-------?--Bo-?BE---------T--E----E-E--|--Mo-|v
-X|oTT----E-?---BX---|-?-?-|------M-----B-X------T-T?E-BB-|MET------M-E--?---o|?--oB---|--E-?----MoXo-T--|?--?-E--XM-|-BBB?T---M-T----------------o--o--X---T-B---T------X---E-oM|---E--X-oBEX------|--f
-E---E-------|----B-----TX-------EMo-EM-T-|M-----BM-M-----X--|-?----B---Xo--Mo---XoB--X--|------E|-X|--o-BT---XE--T-M--M|-TM|--M?---E-XB-M-B------BT--o-----ooM|---B-T-EX---T-ooB--E--|-o-X-----------Xf
-TE----oE-TB-T|-T-?-----o?---X--X-------o-o---XT-------?T---T---o--|M-E|?T----------M|-?-------Mo-M--|-----E-----X---o--------X--X---------oX-B?--BB--B----?|----M--T-M------T------?B------X-B----T---f
--BE-------B--Xo--------E-MB|B|T----oE-XT-oo--?------BT---E--E----------||--M--M-M--ET---|TXE------------XT--|-?-oX-B--?---E-B--M|--Mo-----B-----M--X----|-M-B-ToTM-o-|??|TE?---?-B--?E-----------EXXB-f
-X---T-----o----B--|------B--|------?-|---E--|---TE------oB---o-|-XT-T-|---------|--X-----------E-?BEX---|-----oM---------B-T-EX--?--?-?-------|?--E-M--E--X|o--X|--------|--EB-B-----|----?o-M--E--M-Xf
-?E-?-E-M-BT--E----X-EoBB-----B-------o----E--M--T-----B----MM--|ME---B-|-?o-T----oo-X----------EXM-?---E--B?E--|---TX---X--E-EE-E--|--B-Xo---------E-------TTM---o-oE-T--T-------oM?----T?Xo--o----BT-f
m?o----?-B-o----T--B--E-?-o---E-?---E--X-TMXoT---To-B-X---|--?--E--o|--------o-E?-E-TE--BMB-B-?---??Eo--B--o--|-X--|B------M?T--?--------B---TT-o----M--|-------?--------------EoM--o---?-|-T?-?---o?--X
XXXXXXXXXXXXXXXXXXXXXXXXXXXXXXXXXXXXXXXXXXXXXXXXXXXXXXXXXXXXXXXXXXXXXXXXXXXXXXXXXXXXXXXXXXXXXXXXXXXXXXXXXXXXXXXXXXXXXXXXXXXXXXXXXXXXXXXXXXXXXXXXXXXXXXXXXXXXXXXXXXXXXXXXXXXXXXXXXXXXXXXXXXXXXXXXXXXXXXXX
