-X-?oB-X-MB-X-XoMo---o-oo-B-BMM?X-B|-|oXBX?X-X-o-?oXXXB-X----E?|-M-E-E-?XMXoT?-M---BXX-o|----MXM-o-XXoo-B--XB-o-o?E----Bo-?o--|X--oXo-XX-?MXX-E-?X---EoBX-EBoo-E-o--?--?-XEX-o?Xo-B--?XoX-XXXME--XM-XX--
--oX-oEEo?EBBoXX-X-?-Xo-EX-??--Xo-BoE-?-XTBXo??-XBB?M-?E?oM-X-----X-M-o-E|BMM?---?oXX-oX?MXo-XMo?-o-EBE--?-X--X?---B|--??B-T-XB-T?Bo---MX?-oB-BXT-B-oXEBXXoo-o----?--o-?-B?Eo?M--EE|-??XoX-Bo?--oE?M??B-
-o-o---X-X?-?X--M-o-MB-M?XXT--XXM--?M-X-B--XoM|-XB?X-oMB-XB--X-E-B-X-oBo---?-?-oo-?-?o---o---XX?--B-B-XB?XoT-o-?--?o-BE--oE|--B--X-X?o?--B--X-??-XBXMMB?oM-E--MXXo-o?-X?--oE--T-XB---XB-?XBo---MT?XE?XT-
-o-o--E?-B?-B?EX-|-XXB-XEX-M-o---MX-?-T-BoM-?B----X--TXX-?-B-XT-BM?X?--?o|-ooX--XXXE--B-o-X-?o-o-----ooEEMX-M-?XB--|B--EM?XM-o-XX---?XXo-?XX?-ooX-B?---TEo|XMTM?X?E??o?XE--Eo-o-XX--E--B----B|X-oX-?XM--
-|-o---X---o-oE-XBoo-|?--X-M?EBX-ooB-E-?E-o-T-?EB?X-?XXXMXMo?XX-XoX-o-E-E-o-?o|?ooEE-BBTX-XMX-oE--Bo--E----XEB-MX--M---oMo-M?-??-|oEMo-?---XB-Xo-?Too-XXo?XBX?oBMXB?-X-M?-X--?Eo-E-------BEEo?--?oX?BB--
-M--BMX--BoX--XBMXTXE-X-?o-MBE-|E--EoXBT--ooMX?-XXo?-XB?----?-------XB-X-XBXXE-X?EB-X-X?-o--BE?-|Boo?o-?--X-|X|-?---?XXM----oo--oXo|Xo--??-XX--????-X|o-MoB--X-?BXoToM-BX--oX?-?X-E?X-B-oE-??--E-E-EMo--
--oX-M--B-??X-?BEMBE-BBo|--|BX?BXoX|-XX-XBBTM-o?o-TX?o?|o-o?--B-TXE---?XXEo?---|X-X?oX?B-Mo-?-BXB-BM-B-oo-E|E?|-o----o--M-oB?-E--X--?---X-E-X-X---XoEo----?BX?o-B?-?X--X?X--E-M-EoBo?XX-XMM-XTBo-|-oXXX-
-EoEM--E-X--o-X?--MX-BEMB-o?X----T-M-M--?--|o-B----E-X|--oX-o-oEEX---X|o---o--X-X-XB?ooX-?oET-X---?XXoM?X?oB-o--XT-B-|o-Bo---X|XE--o-BX-?BB|oX-MX-X?--X--o-XXX--?oTE-T-oB--oX-?-M-|--XXo--X-o-o--o-?-oBv
------X-oBX--XXBXoB-?T--o?TE-XEM--XE-B-?XoX-X?MEM--oX---E-?-o-BX-XE-|?MM-M---oBM--E?-?o---MBETX-ME|E?M-oXo---M---oBE?-o--oM-oX---XoXoBMB-MX--o?-?B?---XBEB--X-?-|XB?-??----XB?XXo---?XX-X---o-XX-B?-B?Xf
-BMo-MXX--?--|E---XX-XX--??---o?X----?-?|X----?|-?-X---?-||MEBBM???E??--XX-?--?X-?o--oo-MBX-|-T-?------?EMToo?B?o-M--?o-??|---E-?EMXXooo---E--T-M-T?-B-X--X-o-??T-X?-?X?BX-?oMB?T--o-o|oXX--XE-?-EX-M-Xf
-MME-BB?-oEXoME-oo--EB?o-E--TooTE-B-?---MBM-X-?XXB-EEMMB-oX---?BBoX?XE-XX-o----oXTM---XEBBM-XX--B?X--B|E?X--?-oB--o-oX?X-?--o?X---MM-BXXX--?--EX-E--M-o---?X----T?oB?-E---X?-EE?-B?oE-?EM?BX-XBB--EoMo-f
--|-XXXX-E??BBE-XX-------EEEo--BX--MXMEEX-X?XB|XM-oB---|-M--XXB-o?oX|X-X-X--?oEX?-MX?-B-X?-o-M-XoMo?-oBoX--BEB?-||--MEBMEo--oX---o--B-oX-Xo-XM-oB--XMoMo-E?-BM-oo----Xo---Xo--??oooB---E|-M-?XX----EXo-f
-o?-E-E-To-o-?E-XoBo-T-X-oMXEXB-M-MXEB-X--EoX?-MEB-XBEXo--XooBoo-X|EXBMoM-|?XX-o--M?-?o-?-oB-E-MXoBBB?B?XBXB-XoTEB?-BXM-B-o-Eo-o---X--o?-BB-BBBEoX?--o?-BMB-BX-BBE--?-Xo--?Xo-?-|oBo|XoBB-?--X-o?B-BX-Tf
-X-XX--XMBB---XB?o?-XB--?ooo?XEX??To|-E-E|BBE??-B-B--?X-Bo|MM-oM---?o-XXE-MB?BB--X-MMEM??--X?B--MXXX--X-MBX?--oMB--BXB--BX---oB--?-Bo-oM-Bo-oE-?BXXM?X--BoB-oTMBBX-BB-B--?BBBo-B-X-XXX-M-??oX?XM|EME---f
m---X--XXBEXXoBoBX?TMM-oMMM-o---E?X-?-MB-XEX--Bo-oBX-X---B-B?oXMXBXXM-XX-o-T-MXo-MT-BXoBEX-B-B?XX-MB|o-B-M-XMBM|B-BXXTEo--o--BBB--XoM-BB-B?M????-X-XMMoXBBo--X--M--BBoM--Xo--BXoX?---B?E-B?M|?XTXEXX|-TX
XXXXX-XXXXXX-X-XX-XXXXX-XX-X-XX-X-XXX-XXXXXX-XXX--X-XXXXXXXXXXXXXXXXX-X-XXX-XX-XXXX-X-XXXXXX-XXXXXXXX-XXXXXXXXX-XXXXXXXXXXXXXXXX-XXXXXXXXX---XX-XXXX---XX-XX-XXXXXXXXX-XX-XXX--XXXXXX-XX-XXXXXX-X-X-XX-X
