----XXBE----?o-BX---o--B----o-MXBB-M?|M?E-T---oM-TBo?-o|--E|-?--E-B-MTX-XM-E-XE--M?-BoMT-X?---?E|---BE----MX-T-T-BE?-|XoB-B?X??-B--EX-EBo-T?-X-|EBBB-M--XXX-?EX-BB?-o--B-|E?o-MXMEM-X-B-?--Xo?XX-B------
--?-ET-M--B---Xo--?-M||-X-o-T---BM-X-X--B--B-XBM|B-|---MXB-|o-BB--BBT-|MMM---Bo?oB--MMXoEB-EBoT-B---X?-X?-o-MXBTEMX-M-XB--o-?BBEMXX---?-?T|---B-o--E?E-oX-oBXo-XBo|-B--M---BM-??T-|?X----M?-?--E-?----o-
--oBM-BX-X--M--|X-oXE-?o-XB--B---XX-XXX---X-E?---X---BT-----?-|-M--M?XB?-BT---XM--BX-|-T|BX-oEoEE---?B-B--B-----oTXXTTXM-o-B---oE--|-X-M---TEX-M?o-oX||-oo--B?-XM-?T---BM-XMB-E-o--o---------o?-M-XE-?--
--?--BE-?XX-X--ME-X--B|T---BMXo-oEB?ME--o--B--BoM---oXBX-EBXBEE-----|X-X-?B?Xo----?o-E-o-|---MME--o-?-M-|---B-M-oBB-B-B--o?B|-X?X-EXX--?--oXoXBX-T-ToEoXXEB--?-BX-Bo?|?--B----|B-B?-X-BM?-----o-?E-Eo---
-?-EMo--E?|BX-T-o-?-----|-MM--EXoXE---o-M---?X-o-?BBo-oTo-?XX??--M??|-B-o-MX--?BXM--M?BB-ToB--EM-XE-X-|MB??M?-EMB---?EE---?ME-X-Boo|-ooTo-Bo-MX?-X-BoX-X-B-M-X-E-XXB--o-T---TB--M-XBo-?---B-XXT-E---o---
-BX-|-Mo---B--BB?XXM|---?--X--B--XTo-B-B-o|E?M-?T-EBE-B--XM-B--|BoTXT-MB---XXXE|??----X-o?o?|?E--ME-X----E-ME-oE?X?--oB-MBXoM-XB|X?--EE-oXM--B?--E?-B-o|X-oo-ME-MM-B-B-?-XXooBMM-X-EBX---B------M?|---X-
-X?--?XBBX?-XXE?M-B---X-o|B-------B-o---BXo?-oMB-B-TX-XEX-?ooM????-B??B-M--BBXX-oXBB-E----EM?------oBT-E?-EB----T-|-T-X--oT-?-E-TT-M-BX--BX-M-?oXBoXoo---XTTBB-o-X-M||-X---X-B-o-|?Mo-E-B-TMMo-?ooBXX---
--T--X-Bo------M?T?BoX-Bo--X---BBo---o----BM--B-X-M?Mo?EB--MX?|X-?E--o-oX---MM-BMXoB---BT-XX--B---XXEBo---o-?|o--MMEoBE-o---?T--X---Bo---X--|XT-------E--X-X?---|-X?|-?|-oXX|--T--?BM-??X|EM--X-?-o-?|-v
--?MT?X---XoXTooXE?-?----X?---X-X?|--?X--?-?-|-XX?-----|-XM?XM|--BXBXoTo-Bo|Xo-E--X--X-oM---T--M---TX---BX-E-ooT?oET---?--?-B?|--?--|o-B?B|Xo--E|--B--Mo--X--o-?T?-o---B--|Mo-BX||B-??----BM--B-|MX--?-f
-?-?-?-o?M-XoT-BBoXo--E---?E-o-BX-?o--B|XBo|---|?-BX-XMoB?-oB-XM||-E-o??-oo----Bo----B-|T-o-B-|----?Bo?--?-X|-BB--XEoXXo--oMBB-X-?-E-BB|--MX-o-?-XE-TM-X?T-XE-TE--|oo?TE---T-BB|B-ooE-B|E|-oM-XXXT?|--Xf
------Xo-?B-MXXXB??-o-B?B-BE-E--?X?-EXX-X--XX----X?---B-oEBB-EX-------o-B-X-o|o---?B--oX-XXo-?E--B|T--o---?---Xo?-B-To-X--o-EM?X--?---------BE-B-?--BX-M-BBMX-XM-?-MXX-X-oXBB---T|X-|X--M--X----XXM---Mf
-B--oB---B-E|o---X---?-E---Mo-X?BT-BMB-XM--E-XXXo-?oBX-o--o--oE---??X|XB-MB?--?XMM-M-?----o-B-XB-?BMT|?-ToB-B-M----X------|B--?-X-|--M-o-oXB--?MXEoX-E--o--Bo-o-BMB--M?E|-B-?oXB----?---M-?-B--E-XM-M-Bf
-BX?BBBB-B-?-|-E-BTMEMBX?BoXXo---X-E--Bo-B-BB----X-E-XM---o-BBBMB-B---E-o---|-TXoB-oBo-B--X---??-B-----o-T--o-?o-?BX|XBXMEo--?X---o-B?-X?-o?-|-B--B??----B-E-?-----XT--ooXB|TXXMBB--MXoo-B?--XM---X-BX-f
----X-B|--------------XoX-M|?-BB--o--oXE-X-?-oXX--MX--X?o-BX-||?M---X-E|BT-T-oB|----BX--|X-X-EoT--MEEX---Xo--oXE--o--o---o-oT-o--BX-??o-M|?o-MEo-B-oBXXT-X--XB-oBMX?X-o?-|-X-Eo--M-MMo?-BoXE-o--E-T?X--f
mo--M-BXB?T|-?M--BT-BM-oX---|--BEEEM--T-X---T-XB--|--EEoo--B-o-?--XTXo-?BT?-T--?-T?--X--XX----X?M-X----------X--XBX--??B-EX|X?ME?M-?-MM--X-X?-X--?XX---X?E-B?-T--BTEEX---oT---X---X---MX---TB-?----B|-oX
XXXXXXXX-XXXXX-XXXXXXXXXX-XXXXXXXXXXXXXXXX-XXXXXXXXXXXX--XXXXXXXXXXXXX-XXX-XXXXXXXXXXXXX--X-XXXXXXXXXXXXX-XXXXXXXXXX-XXXXXXX-XXXXX-XXXXXXXXXXXXXXXXXXX--XXXXXXXXXXXXXX-XXXXX-X-XXXXXXXXXXXXXXXXXX-XX-XXX
