----------------B----------------Eo------?---E-X-----------E-X--Bo--------------XMB---B--------?M-o---B----o-------B-E--EM---------------XXB---------E---------------------|------M-------------o-------
----M--X-------E--X----M---o----------E---B-------------------------?-----------B------------?--o?------?--E----o--E--M--------?-------X--?------o-------o----E--o-X----------X---X---E-----------------
-o--------B-----o------------X-----M-----M-X------o-B----E----o----------------------o-B------X-------B--o----------?MB--E------E----M---oB----BM--X----------M-------------------o------o---E----------
----X--------B---B------o----M-?-------B-------X------------X---B---M---E--------------o-------MB----B------o---EE----------?--------X------------X-E------------------------E---?-----X-E---B----X---E-
----------M-----o-----------------?----M------?---X--X------?----------------------------X--------?----B-X---o---B-----------------------------X--M------------E--------------------X---------M----o-?--
---B----B-M-M-----X-----------XM--E--------X----M--X--E----------------------o-----M---B-------------------?--M-------o--------?----------?-o---------------------B---?-o----o-----X------X-------?-----
----?----------EM---------------------------X----------MB-X-?--B---------------E---------?--------------X-MM-----?-E------?--------o----------B-?----?-M-------X--------X-----E--------E-----ME?M-?-----
-------o-M---M------E-B-----X---M----------o---M----X?-------B--X------------?oX--E-B------------o---X----E----o---o----------------------?--X-X-o----------o--o------M--X--o------?o---------B----o---v
---------o----------------?-----?B------o------------------------o--E-------X---------------?--------------X-----------------B-----------XM--o-X-oB-----------B---?----B---------------------o-M-------f
-----E-B--------B-----oX-----------------------M--------??------------E-------------------o--o---E-------B-------o--------------X-o-----------o-?------------o---------X------XX--X-------M-XE---------f
---X----?M--------------?-B------M?------E-B----------E---------o-B-------------B-------------MX--------------o------------?-------------------BX-------------------?o----------E-----------?-----M----f
------X--X?-----------B---M--?--E-------------B------------M-----?-------M-------X------?------o-----B----o--X--X-----o----------------oB-B---------M-------------M--B----------------------B----------f
----MT-Mo-XX--EoB-BTXX-TB-T-XTo-------X|------T---oTT?TT-oT--T--ToT-----EBT---B-T--o-?-?-?|?|-oT--X-M----T--T-T--o-BTET--B--T-X----?o?BB-X--X--B-TT---T---T-M?B--------T---T-B--B----E?X-?X--|E-T-T--TTf
--o-E--------|-------TTo----T---M--------B-XET--M-T---T---T--E--X-T-|-X--Eo|-|o-TBXT------E--T--o-X-o-o-X--?-------?X--E--X--E--?---B-T-|-----T?-B---B--o-Bo-ETX----X--EBT?Xo|-oEEXB---X-XEX---E---T-?-f
m-------------B--T-B-B-T---EM----T--EB----?--M---M-T-E|EM---M-EE--X-T-E-X---BXXT-----oM----T----B----o-B------o--|------B-o-oBX-X------To?oT--E-------T-----X-o-M-X-----E---TEo-M--X-?TE---B-o---M---?-X
XXXXXXXXXXXXXXXX---XXXXX--XXX--XXXXXXXXXXXXXXXXX-X-XXXXXXXXXXXX-XXXX--XXXXXX--XX-XXXXXXXXXXX-XXX-XXX--XX-XX-XXXXX-XXXXXXXX-XXXXXXXXXXXX-X-X-XXXXXX-XXXX-XXXXXXXXX--XXXXXXXXXXX-XXXX-X-XXXXXX-XX-XXX-XXXX
