-BX---------X--T---?-E---------T---T----X---E--oX--M-----------?--|---M--------E----T--?---E----B---?-oB--?M-----T----B-------X--B-?------oE-X---------o|o--?-----o-----------?--|X-||--M---------------
------|------------|-B----------X-EE--B--B------------o?-------------M?---B------o---------------XE---X----------|----------X---------T---?---?-----------E-B-X--------------------------------X?---o---
----BB|---X-o-----------------------B---------?--o--M-|----X-------------?E-------------B--T-----------?----M------?M----X--BE---------X--------------B-------B-----------o------------Eo----X------o---
-Eo---M------B-o----------M----B-T|----B--M-----M---?------M--------M-T---T-X----E----------B-B-----------?----B-E-B--------X--X?--?--E-?---------X-------X-----oXo-------------o-|----o-B-M---M-----X--
----X---T----EEXX---X---o--------T----X---M----E------X---o--------B--XB?--------?----EXE-------?-------B--------------M-B---------------?-----X--M-----E----o-X--------E-------?---T---M--B----E-------
------M--M-X---------X---------M-----E--|------B?----M-----?-------------B--B------X-------B--------------?-T------------M----------X---MEX-----------MX--B-E--------------B-?X---B--o?--?--------------
--------M--o-o----o---?--?-X-M----E--X--B----------------B------------B------B--B--|--B-?-----?-----------B--X--------T----o----------M----E----------o-----------o-M--X----------B----B---E---B------X-
-o-BMo--B---------X---------oo---?-----------TX--EBX-??-o----X-------E----M-------E-B--------------T----------------------?-----X-----------------XB------o------X-X-------------T-----XM--oM----------v
-T---------------M--------E---|M----X----------XB---XE--B-|-?------o----X------B-----M-----o-X--------X------X-X---T------|B-----------X-E-X---BTM------------TB--------?-B-----------XB----o----------f
----o-----------B-------B--o-------------T---o------?----------X---?----------X-------B-X-----------X---------E--?----------------------------E------o------------------o---B--X-------------M---M-----f
---o-E----E--X-E--?-o-------X-----?-M-B----B-o|---------------B---?--TX--M------X----B---------------o---E--B--------------------B-----TXE-----o-B--------------E-----------o-------X---------X---X--?-f
---o----X-------------------o-X---------M--E-------E-----B----oo------|-?----M-?X-------?-MB----T-----------B----T--B-----B-------oo--EB----------M-----?----T-----E--EX--X-----------M-?----B?---XXB--f
----o-B-E-B--M-----o------?----------------------------E-E--M--?--------------X----B--|----------M-----------E-B----X-M---?----X---o--------o---X---M---o-?Bo------E-----M-o-M-------X------X----------f
-----X---o-----|--------T-E-X---------X----M-----E--MX---|-----T------M---------?------------M-------B-M---|-----------oo------MB----X------|---B---T-?-------------------X---------X------XM|-o-----T-f
m---?------------BM--------|--B?--?-o-o--M-BX?-----EB--?---B--------BBo------B---?-----X-----o-E-----X----XM-------X------------T?-T?EM-M----?-----X-------------------B--?---M----o-M--E--X---XX?--?--X
XXXXXXXX-XXX-XXX-XXXXX-XXXXX-XXX-XXXXXXXXXXX-XXXXXXXXXXXXX-XXXX-XXXXX-XXXX-XXXXXXXX-XXX--XXXXXXXXXXXXXX-X-XXXX-XXXX---XXXXXXXXXXXXXXX-XXXXXXXXX-X--XXXXXXX-X-XXXXXXX-XXX-X--XX-XXX-XXXXXXXXX--XXXXXXXX-X
