-------X---------------E----------------oE------------------E-??-----o-o------------X---E------?-----X----B------o-------?-------------?-----------B----B---------BX------------X---------E--X----M-----
----?-X-----X---o----------o----------B------o------------------------------B----B-M-----o-o------------------X-----?B---------M--X----------X----M-------------EE---------------o--M---------E--E------
---XX---------------B-----------------------------B------------o------------X-------------------EE-----M---o------------------------------------------E------M-----------?-B-o--E---------X----------o--
------------o---------------XX---o----M-EB-?-----o-------E-?-----------M-------------------------------o-------------B---?--X----B--------B--X---o-----------------------------------------------X------
--------Bo------X-----------E--------o---?---E-------X--------M------M-?--o---B---M--------------?--o-----M-------------B-----o-----o--------------X-------B----?-o----o--XX----X-----------------------
-X-XB--X---------------M--------------------X----?o------BM----------X-----------------?-o-----o-----EE----B--?-o-----------?-----------M?---M---------EBo-------o---------?-----------------X?---------
----?-------------------oM---------------------------------X---o-----------------B-----X--------------B--------X-----M-X------X-------------E----oX--o------------------X---------o---------------------
--------X---oB------------------------X--------------E-B-----X-X----MX---X------o----------------E--------------X-------o--------------------------------o-E------E--------------------------B---X--?-Bv
-XX-------------------------X----B----B------X---------E----------E--o--------------------o--o-------------------------o--------X-------------?-----o-?M-o---------X--o?-------------------?-----------f
-------------------------o---B--X--o-----------------------------------------B-----------------M------------o--X---------o-----o-----------------?---------------------------E---------XX------o-B--X--f
-B-----------------o--B----?--------------o-----------------B-----------B---?-B------------------X-Eo----------------BX----M-----------------------------B--o------B-XXX-----------B--------------o--?-f
--X----------------------M------------------X--B---B----------------E---------B----?---o-----------?o-------------------E--o---M----o--?------------------------X-------M--B----------o-X----?o--------f
---------E--M-------B-EB----X------o--B-o---o--oBo---oBM----o-------o?-E----oB?B--------X------------------BM--XoB-------o--o---?-o------B-----?------o-----oo----Eo----?-B--o----------?-------B------f
-------------o-----M?----E---X-------o--------------T--B-------------E-E-TE---T-----------------T--M---E----X-X----E--E--------T---------E-E--ET----T------B----o-T--Bo--EEM--------E--?------------T--f
m-----E--o---X-----?---?-----T--E-----T-o-|--X----T?-E?--BME---------E|-------|E---o----------o-|---B-------M----B---T-E--------T---E------E--o-o-To|--?----------|------T-------T-T?X-E----M-?o-Eo-|-?X
XXXXXXXXXX--XXX-X--XXXXXXX-XXX-XXX-XXXX-XXXXXXXXXXXXXXXX-XXXXXXX--X-XXXXX-X-XXXXXXXX--XXXXXX-XXXXXXXXXXXX-XXX-XXXX-XXXXX-XXXX-XXXXX-X-X-XXXX-XXXX-XXXXXXX--XXX--X-XX-XXXXXXXXX--XXXXXXXXX-XXXXXXXX-XXX-X
