--XX------XX--B----------X---------------X--------o----E-------------------o----E--?---B--------?-----X--oB-------M-----------------------------o-----------X-?----M------M---------------?---o---------
------X-------------oX----------E-------------------o---X--------E------------------B--oE--?-o------M-B--------XM---------------------------X--o--X-------X?--E--B--------o-X------o----oB----?XB---MM--
---------E----------------------M----E--o---E------X---------B---------B-------------E--------X--------oM---oX-----------?--B-X--o------------------X---------------------X--------------------o----?---
---------E---------------------E--oM----oX---??--------o--B---------M-------o--------------------------X---o-E-X-----X-E-------M--EM-B----------------o----o------------EM?-----------------------------
-M-B-----o--?--------?B----------?--?-----?-------X------?------------B-M-----B------------??---X--o--X---B-----?--X--------o---E--E-o-----X-X-------------o--------------X---------X-E-ooB--XB---------
-E-------o-o----|------oB-?-----------X------o-----o----------M--------------------------B-o----------o?------------ooB?------------B--B----------o----?-----M?---?-X---E--------E----?----o------------
------E---B---?-----?-M----------------------------M----Eo-------M---------o--B-E-X-----------B--B-o---E--o-M?-------------------------E--M----|-----B-------M-?------------X----------------------B----
--------------o--E--E------o------?------B------?----B------|X------XE-----------------o---------?---E--?---o--E-o---?---X------?-------?E-----|-------------o?----------M-------X---o--o----E-X-------v
--o-----------o----B----------B----M----X----?o-------------|----------------------E---?---------o----?B---X------------X---------------o----------------?----X-------?--------X---B-X-------o---------f
------|-B-----B-------X?-?------------------|------------B--o----------o-o----?-----E----?--o-E--B------X----------M----X---------Xo---?---B-E-------------o----------?----o--M---M---X---------------Xf
------|------------------------M---B---E----|o------M-------------M------------------B------X--X-----------------B-X------M--o-------------------------X---------oX-|------------?-X----E-------X---o-Mf
-BE---|-------E-B--?------M------X----------|---------------------------Eo------o------?--E-----------o----------E-------o------X------------o-|M---B--X--XX-----XE-|--oXE-------------o---------------f
------|X-o?E-oX--M-?-TT-TMM-------------------------?M-TB---X---BB---M--o---X-M-o-o--ToB-M-M??----XM-BB-X|-T?---MT---E------ET-TX---E-----BT---|-X--B-X---M-?-T-TB--------T--M-X-BTT-X----X----M--T---?f
------|--T-|-T|--E|-E||-|----X------|-E--E-T---M-o|---||-X--T-----XE|----?---|--M|o|-|T-T||---E----|--M--|-|T|||-|E-E-------?|T|-o-----B-MX|X-----E-------B-|-|-|----|----|o---EM-|T-------?----|E|----f
m-----|E-|o|-?|-EE|--||?|---T-o--o--|---E-o|---?T||----|E|BM|EE--------|-|---|-|B|-|-||-|-|--B-E---|-|--B---||||E--------M--Eo|||-E|-T-BX--T---X--oX--X-o---|---|B-M-|-TM-|E?-T-|E||--E---E-----|B|T---X
XXX-XXX-XXXXXX-XXXXXX-X-X--XXXX-X--XX-XX-X-XXXXXXXX-X-XXXXXXXXXX-XXXXXXXX-XXXXXX---XXX-XXXXXX-XXX-X-XXXX---XX-XXXXXXXXXXXXXX-XXXXX-X--XXX-X--XX-XXX-XXXXXX--XXXXXX-XXXX--XXXXXXXXX-XXXX-X-XXXXXXX-X-XX-X
