--o-TET-T----oTo---|-B-X|EXBBB-Xoo-o-TT?TT--oTT--TX--T----EE---|--TEMoE-T-|-|TT--XoE--To-T-oM-T-----E--XE-E-oB-TTXB-oooTEo|oE--BoB-Eo?-T---o--X-T--?MoE-oXo--oTBT?oX-XTTTXB?-B-MMT--B---?o-ET?E-BXoTXo?-
-ToM-o-TMoT?-T?MXM-XTTM-TX-BoEXXX?-E-BT-|T-oMB-XoTETMoET--T|TM?-TM-MMB?-XMBT---To-T?|oT--T--TT-MMT|--?T-BT-T-BT-T---??oXX--oTX?oo?B-ETX-oXB--o?|M-B--|-T-?T-|?T|TE-T--T-o?BMEETETX|oB--TTT--TET-M-oTTBo-
-oM?XB?--T----E-?E---ToXBBXX-?-Xo-TTo-|?XoTTMMETXoTo--MXTBEE---XXBEoBX-?BBBMTo-???T-X--XX-?-B?X---|?---Eo--BT--TB-ooo---|TX-XXT|T?oTo-TTMXXT?T-TTXTT--T-MX|oB-oEoBoT|oBTX?|-To-TM|ETE?X-oXX-T--E----oEo-
-Bo--BB-MoBBMETMo-BTXoBETo?B-TT-|?TMX-?XE??-XoE||-E--T-oTBMoTMo-?BB?-?--TTooTToo?--ME-ET--ooB-M-XBTTBT-TTTEXETMMTToT-BTBT---X?TBoXMo-X?o-T-XTX--TBMTXXE--BX-Too?-X|-XE-B|B-X---TM-M-XT-MTo-BXM|T-|TXT?B-
-oTX-B--E--B-XXX-XX-XTBT--oEX---??-To--?TT---ooX??BMBE??--XETT?T-B|BEo-Xo-T??M--BE-EBBTTET-TM--XTT---T-EoTT-?BTo?-o-oM-?-?--?X?-?-?XTX-XXT-To-Bo-?T-TB-B-oM---BT-oT-TTo|EM--B??--M?--M---ToM-E-B-T-?XT--
-o-X-B-o?-?-X-M---?---B--Bo--B--MoTTB-oEo-MTX-oM?--XTBXXoT?---o|-?--ToET|?o-------|-E?X-Eo--X|?TT-XBo-B--o-oBTo--Eo-XTTBXXB-XET-X-ooB?E-BoB-?XBT-TT--BXoTMEX-XoXTT-MTTTTT-|?----?T-TM-X-?BTT--o-|-MEEE--
-oET-B-XoT---?-XMM-T?----o-X?Eo-X?X--|-o---T-T--T-T--XB--?o-BXTB-BT?-?|T-BT-?o-BTTM-T-T-B--oX---XT|MX---M|oo-X?-TTT?o?|-T?o?X-TT-BoT|?-XMBoMTX?-B--T----TEXoo---B?T?BX-|-E?EXoXo??TXT-?X?-?X-TE-oM?X?oX-
-XT|oE-X-XTX-B-Bo?X-TTT-?-TT-TT--oT-T-BT-|?M-MXMToB---?-EXX-o-o-TXTX---MX-T-|Too-X|--oE-M-o---XM--|-XXToEo-T-Too--MoB-B-TEXTEoM-?TT-?-XTB-o-?--XM-E-M-E-M--M-|-E-TTXT--BT-T---?-BMXB-oToXoB----?-?E-BMBv
---XToT-B?oBoTX-oT-oT-EXXTT---?BToXoTTB-?MT--X-E-TXXET-XB||B-TBX-M|-X-E-MMXM-?BMo-EoTM-|TE-?-T-?o|-X-T|-M--oM-ET-XT?T|-M||BT--X--BXB-Xoo|-T?Bo-o---oToEo-BEo?-T-T-T--?ToB--TX-X-oTooTTBoBoEX|T|T?X?-oB|f
--TTooT-XB-E---o--EM-M?TE-XB--?T-?o-Xo-?M-?B---T?o-o?-XoToT--oT---BMEoTBMTo-ToEX|-XB??E---o?-EMoX-X-T-TE-M-oTToBX--oo-|o?Xo-T?B--TE-T-XXM-TBXo-TBXoTX-EEoB?XE-B-MT||T|o-----XoMBooXXE-ToBT-TE-MB-?---TMf
-BXoX---XE?|-XXX-?-oo-BoT-|E-T?XoXE-XET?-T-B-oM-oTBo-T---TT-o-o-BX----X-?--Bo--BT?T?T?-XoTEXETTTXX-?|?XBBoooT-X-oo|E-?EM-?-oTTo-M--?X----TE-?EE?TX-oT?oEEM-oMBoT?TT----TXXT-T--|-oo-TTMo?TMTMT-X-M--oB?f
-TX|B|?-|-?-XT-T??B-BX-TX-B--MTT--TTBB-B-o-XB?BTTX?--X----E--T--X?-B-oXBoXX-?XBM-ooM--?XBM|-|-o----EB--?BX-M-XBE--TM|TT?-|-|-o|ToXT?-B-TEX-ET-T-oT-T---o?ET-?XTT--E?-----?MXT-XoXX--B-X-T-X??--T-TT?TT-f
-B-o-?-oX--E-MM-??MooBo-XXMo|o?X-BB-T-o?BM--XE-E-EBo-XEBoB-?M-Moo-?|T??-B-oX-XXoB--X-oXM-?MB--X-EM-?B-?-oMB-?o--|??MXMX------?BB?--M?BX-|B-XMM-XBM--oBo---XBTET-?-XBo-Xo-B--B-MBX?BXMoX-M-o----oXB----Xf
-XBo-??--M?B?XT-XX-XE-E-BT---M--|???BB--oBMMoo-B-ToXBoMT?TX--B-BoX-X?o--M-BE-E?-oX|XoXEoo--?M-B--oooMoEM-B--X----XM?XoXT--X?XBoo?-Bo?X-EMT-BBBXXXoX-M-BoEo-|X-X-BBX-BXBMX-----oXXX-E--|??EXoB-XT-B-M-MBf
m-MEBEEo-XM-MMMo-o-?TB??-X-BE?-BXB-B?MM-BBo--?M-X-MB??B-XX-E--MBXM-?o--M-o-X-?Xo----MBooX?BX-T--MTBXXEoMX-X-BXMoE?Xo--M-TT--BBMB?--?B-MBoo-Bo---BoBB-EBo--EXB?-BX-Xo--X-BBXE-EX-BoMBXTE-XEBB-Xo---X?oM?X
XXXXXX-X-XXX--X-XX--X----XXXXXXXXXXXXXXXX-XX-X-XX-XXXXX--XX-XXXXXXXXXX--XXX-XXXXX-XXXXXX-XXX-XXXXX-X-X-X-XXX-XXXXX-XX-XXXXX-XXXX--XXXXXXXXXX-X-X-XXXXXXXXXX-XXXXXXXXXXXXXXXXXXXX-XXXX-XXXX-XXXXXXXXX-XXX
