-----M----------------E--------------?-------B------------o----------------------------o-----------B-E-----M-B--------oo-----------E-----E---------X--------BXE--------------------------------------o--
----------------------o---M---------B-E----X----B--------------------X------------?------o-?--------------X---o?M------E-X----M-----?---o----------------o--------------?--------M-X---X-o--o-----------
------------------o---------------X-----o------------------?----------------?E--o-----X---X-o-?----o----B----------E--M----?----X---------Bo-X----o-------------------M?-----B-o---o-E-B--o----o---X----
----?--o----------X---E-E---------?X----BX--o------o----X?------------o-o----------------------------------------------------B---------?B--------------------o-o---o-----------X------B--E?------o--?-E-
--M-----------------------o?---?----------o?----------X-----------------o------?-X------------?--o------------?--o---------------------------X-?-------E-----X---M---o-oX--M----------------------------
---------------X--------o---o--------E-----------o--?-----o-------M------------o----E---M--o---------------o-------------E---------------o-------?-X------?-------X-E---o-------B----X-----X-----M------
----------------------MX-------------B-------B--------------------X-----o-----B-o----------------o-?-E------BM--------B------M------X---M----?--B-B---o--------------oo---E--------------------?--------
-----B--EX------------o-E------?-----------?--o----?-----o----?--------B----X---E-------M--------B-X---M---B-----------B------------------XX-?X----E--------B----------X--X-E-----------?X-X-X-M-------v
---o--------------------X---------?-X----------B------oX------E------------------------E-------M?---X--?---B---oo------------ME---X-E-o----?-o----X------X-----------B--E----M-o--X----------o-?-o-----f
-?M----E-----?----------B-o------E---------------------M----X-X-o-------X-----------?--?-----M--------B--E---------------------------X----E-----E-------B---------------B--B--X-----E--MEM--------o----f
----o-------E-X------------------o-E----------o-o-------X------M---o---------------X-------------M-----------?------X-------------o------------o------X-------?-X------------E-------------o-----------f
----------B------E----------E------------X--------------o-------B-------------X-----X---o----B---B---------------XX------------------o----oX-E-----?------?--------Mo-----B---o------E------B-------B-Xf
------Mo--E--?--T------EE---MXo--TXM-o?|-T---|--TB--|-oMB--E----oT---|X---T-?-|--?X-E---MT-?----ToXB--X--o------T?-?-o-o--o-X--oX?-o--?--XT-M?oX----?--M-TEM--B-?XT-E-|T-o--T----T?-BM----MX-X-o-TX-T--f
------|-|||---X--|--|||--TB-------T||--|-?--TB|------T-|-XE-|o---TX--TT-T-?--T---|-B|T--|---T|---T--|-B--|----||-||o--E|T|T-T|||-|?-|---E||--oET----X--|-----||B|-T--|---|ET?-----T-||--|-|E-o||-|-|-|-f
m------X--|T-T-|T----?T-|T----|-o|T---|||-T-|------o---|-?---|--T||---T|---T|----|T?||TT--TE----To|-o-TBT-M|||---B-|----X|---|---------T|-|--T|||T|M-TT--?To?oB|X-|?X-------XX|TT-oE--|--|---E-|--o|E||X
XX-XXXXXX-XXXXXXXXX-XXX-XXX-XX--XXXXXXXXXXXXXXXXX-XXXXXX-XXXX--XX-XXXXXXXXXXX-XXXXXXXXXXXXXX--XXX-XXXXXXXXXXXXXXXXXX-XXXXXXXXXXXXXXXXX-XX-XXX--X-XXXXXXXXXXXXX-XXXX--XXXXXXXX--X--X-X-X-XXXX-XXXXXXX--XX
