-X--Bo-oX--XTX-E-EMXTX-TTTXX-?EE|ToXBT-TB---X|-M--X-X?TBX-X--X-B??o-XM--TXoMT-T--MToTX-T--TX-BEBoEBo?BEBE|-o-oBX-|oo--oX-X-T-?MT--ET-oT-ooTEo|-?-E-XooB-?Xoo-T|-?Xo?TB?-B-M-oT--o?-M--TT-o-T-T--X-MT-TB-
-E|TE-|B-TM-oTTXE-E-|T?--BT?B?Mo-oEB?|-oTT-MTB-M-BT-oB----oTT?-BTB?X-o?o--|EBTXoXo-?-?oT--ooooBoo|-?TT-?o|---T-------TB-TTo|ETTXo-X--oMoo-XTX-o|-|--TTEMTMTBXB-T-X-oET--TXoT-oTTo---X-TT-oXM|TTEXBBX-?|-
---TX---MBMT-ToTo-XX-o----EBTT-XoXB-T|B--XT-ooTo-B?EoXXE---X?To-M-oXTEXoo--oT-X-|oTT-TX-X?TT--XoB|-To-ETXBXE-BB|T|MTT--TXoTToXTB--oXX|?-X-oTEM?oTTXBoBT?ET--T-M-B-TTMX?-M-o---E-XXMo-XXE?---o---X-BME?T-
-T?oMEoo-MX-TXoX-TTMEM-TT-To--XT---?-X|-|M-B?BBBMXT?oT-M?X--oB?M-MET-o-T-?o-?XB-MTToX|-M----TX--o-BoB-M-M----T-T-?XT----TXEXoBT??T??X--oXoTXX---X-X-TE|E--TXTTETToTT||EEMT-||XT-T-T-EE-T-??-oBoXTXXX--X-
-?EM--T-oM-ToBo-T-T?Bo---??|-T---To?M-TT|o-o--oBX-oM-T?T-X--E--E-o-TXo--XooX-ETTToEoXoMBMT?--?BB-TTXo--X--oB-TTM-EBTX-?T?-MX---ToTTT?-EXTET-----BoM-?-TB-TTBooTT|Bo--TT-M?o?To-E?--?B?-o-TTooTX?TXT|XTM-
-o?|BX--T---TT-X----X-oo-T-TX?o-X---BooT-TTX--E-?o-oM-XBo|XBT??TT--M-MTTTXTXXT--XTB-T-T-T--BBME-|TT-MTXX--?--M?T-XEBTBTo-o--TXoM-oT-?oT?TMEETo-TM-oM-XT-oBTTXoE----T-o-ToBoXBXTX??--TT-M-ooT?X-?TMT-T---
-TXTX--X-?-TMET-X-?TX-TTo|XTM-BB---XTX-T-XB|-?E-TTBETXB---XoBT?|?TTTX?--oX|-?TMXE----EEB|-?TTTEB-XTo-E?-----E--oTT-BT-o-MoBT-XTXT-To---?-E?oXX---Bo-X-oT-?-E?B?|o-B--T-XoTo-TXBXo-T|T-?T-oMoB--B---?X?E-
--X--Xo-TB-To---??Xo-o--T-o-M|B-X|?ToX--oo-o?o|BoTM??oTX----oTBTBTMTTT?E-ToTEToXoMTTX?X-XB-EEoTXoo?oEEoTM-TT-To-XB|-|-T--Xo?--BMBBEE-M----XTTX?--BoXX-oBBoTB-Xo-?-To-?X--o?-X-T-XX-TT-|-XMT?X--T-XT-B-Tv
-?-XM-oooT-TT?XT?--MToo---X-T--MBooMoo-ToXoTT--TMBoo-TT-T-?--?----T-EMoo--B-M-T?-B-EooBTE--X-T-MM|T|-X-TT-?--oT-T-ToXoTT-TEo|-XBo---E?--T--?TT|-o--X-ET--T-oEMo-E?-oBoXT-|T-M--MTET?ET---T--XX-oTTEXEEXf
-?MMTM--T-To----o---TT?Bo?o|ooo|XX-?-oMM-o?---T-BoX-TT--TTX-|-|T-B-o?oXXXM-BT-?T-T--TE?E----TT--BXo-Xo?-X-TMT|-T-BT?o---TXTXX-o-TX-o?T-|-T---M-o-MTBT--T-XM--XT-XX-BB|To?BET--|T-XoBBB---BoEXB-XMo--?T-f
-oB?T--?To--TX-----XBBoE|-BTT?E--T?-XMoXEEB|o-T-M----TT--oo--?T--|--B?M?X--o-B-B--MTT--XXT-B-o-oT--BTEoT?XX-X|-T-M-MMXXXETB--ooB-?M|M-o--TXoB|T|ET--oTX?o---BTTET-TTXoTX--TBTo|------T-BTX?oooo-X?-ToTof
-XBoX-X-MM-XMXo|---oE-o-?T---TT-XM--X---o---M?--B?-oMXoT-TooToX---|oMo--XB-X--|MTo|-M--X?Too-T--M-T--TT|-oX-o-M-TEBMoM-?XXX|-BTX?-T-o---oB-o|MM-X??o-BoE-|-XX-oMBEMoEET-BTB----|oT-XX-?Xoo-To?-BT---BE-f
-BT?-E--o-oB-?BXooE---BTM-B-o??-E-oMX-?B?-?BXB?-Eo?M?-XT--X-XMMX--?-TX-MB-oo-?M?XoBEE?T?oBB-ooTB?-BMX-?-M-?o-X-M-o-X??X--o?-ooB-XoBB?|BX--XE-?XBB-?--BoBB---BTXoBoBXX-X-Xo?X---oBXXXoE-?B|o-E--EM--o--Bf
-BX---B?-EX?X-BM-XBB-o-E--XBB|Mo-XoXXX?-XX-M-EX---M?-oE-oB||??-M|--B-E?-XMo-X-B?-o-XBB-X-MXXXM?BX-XBX?X?E?-X?M----oEX-??B?-|o?-BMXXo?-oXB-oX--XXXooBB?-Bo-B?-BoX?--?------X-|B-BB?B-oBXX-?B--X?-ME|Xo-Tf
mEX?-B-E?X--BX-X?EB-|?-B-oXBX|BoXoXMoXB?XXoXo|-?---?-BB?-oE?oT-?--?oXX-oX?MB?|BXX??---o-?o-BXX-MBB-ooE-MX-B--?--Mo-oo?BXEooB-BM-X?XB--XBTo----B--|-o--MXBBB-BXMETTE--X|??|XX?-X---BBXoX|?BBEE-BB--T-M--X
X-XXXXXX-XX-XX-XXXXXXXXXXXXXX-XXXXX-XXXXX-XXX-XXXXXXXXX--X--XXXXX-X-XXXX-XXXXXXX--X-XXXXX-XXXXXXX-X-XXXXX-XX-XXXXX---XXXXXXXXXXXXXXXXXXXXXXXXXXXXXX-XXXXX-XXXXXX-XXXXXXXXX-XXXXXX-XXX-XXXXXXXXXXXX--XXXX
