--X?----X-----------?--------?----X-----------X-----MM-X-------------------o---X----o---?--o-BE--------------Bo--?---M----?------?------------?----------------------X-----------o----------X-----------
----o------M-M--------o-----?-B-------EoM-X-----o-X----o------------------X---B--------------------M------X-X?-------X--o--------M--------Xo?--------X----------------BoX-------B--oX----------X--X-----
---------E------------o-X-?---X----BE--?----------------X----------X-o----M-------------------o-----B----E---------XB------------o-------------------B--------------------X-------B-E-----------?---E-o-
----------X---------X----------------o-B--X---------?-------------?B-X---------X-----??--X-------?-----------B-------B---Bo-M----X------X----?-??-----?----X--o-------X-----X----------?-----------E----
-------M--------------B-----X?---------X-----------B-------M-o-----M--------------------BMo-------X--Mo--M-M--o------------X----------?---E---------------X---------?X--o-E-X-----o-B-o------B-------B--
--?--------------B-----------X-X---?B---o-------M----------------X-------X---------X-?---?------------X----------Eo--EoB--B-------o-------X--------E------------------------Xo-X-o-----?--------------X-
--------o--------------------------------------------EE-----o--------?------X-------M-o-----oX----------o-----E----oX-B--?--------Eo-Eo---o------?---o--------X----o-------?------------M---------------
---o------E-E--------X-------?---------o-------------------Xo-o--------------XX----o----o--------------------o--E-------------o?----X--o-------------?---X---X-------------B--E--------M-E--M----------v
----E----?o----o------------X-----B---------------------Mo--------------?-----------o--B---------M--------------------?-o---------?---B--M-----------?---?----------?-?--------o---?---------------X---f
-----------o---B---?-------------X--?----------B--------------X--------X-------E-o----------------X---------------E----X---o--?---------B------E--------B---------E--------?---M--o-X-----------B------f
-----XBB----------E-?-----------------------------------------------BB-E---------------------E-----B------------BE---?---oX-M----?-----------X---o------X---E---ME----Eo-----E----------?-?X-----------f
--B--?----?-X---E---o----------E---M-?-E-----------------?----------------o----o-------X---------o---------------M--E-o--M-E---o----------?--E---------------o--B----MM-----------E------E---o---------f
-TTE--X--XMMo-B--T-M-oXTT--TBT-----?---X---?---T-BB---X----T---T-X----M----------X-X-E-o-|-Xo-X---E-M---TT-X?B-o------TT---EX---XEXT--------T?-------T-||B----?---o----o--o--oo---B-o-XT--M-X---T---T--f
-----B?--|-E----M---MT------BT---T-Xo--X-BT-T-o-XX-TT-|--T-oT?T---B-------?--T|To-T-oM--?--T-T---XT----oT---?--M-------oX--?-?---E---TX---TX--MT--o--EB-----M-TE--T-----|-T---?EET-|?---XMT--?--?-T-T-of
m-------T--T--------T---X--T-X-MM--|--T---XB-XB----E-X?MT--|-X----BM----T-----E-TB-??--T-M?-B-T---T------T-o--E---BoX---ooB-X--E-X-XB------o-?B-TX----o---B-T-X---T------?-?T-TXoXE--X---oT--E------T--X
XX--X-XXXXXXX-XXXX-XX-XX-XXXXXXXXXXXXXX-X-XXXXXX-XXXX-X-X-XX-XXXXXXXXXXXXXXX-XXXXXXXX-XXXX-XXXX-XX-XXXXX-XXXXXXXXXXXX-X-XXXXX--XXXXX-XXX-XXXXXXXX-XX-X----XX-XXXXXX-X--X-XXXXXXXXXXXXXXXXXXXXXXXX-X-XX-X
