--------------BTM--B------XB-----------B-?---X-----------?-B---M-----o|o-o-TB--|-M-XMM-------|-T----T?----??--M-----------E---X------M--E-B----?------------E----oE-E-----------MB--o--X----E|-----?B---
--M--?-------|M---T-B---MM--?-|-----E------E-B---T--X----E-----E--------M-----T--X--T?-X-----TX-M--T?---M-B-BX---T----X--T-o------|---o---------EX---T--o-X---M---|---T------T------------X----E-EX-----
-----T-o--|-T------X------B-M----M--o--M----|B----?------------T--E-B----E-XT--------E---------E-B-|-----ET-----|-|--?---X-M---o----XM----o-------E-B---TT----------o-M-------?--BTXMT--------E-X-----E-
---|--M---o-X----------?|o------XEB----T------------X-o-X-----X--T--|---?-----T-------EX---X----X--T-?-----------T---BX-----|-M|-EE-----BX-----|o---|--E--?|-B-MM--X-?----?--oB--------M?M?---M-T-------
--B-E-X---oo---o--oB-|--EM--------|------|--M---X-----T---?-X------XB--X-------------B------?-?---E-M|E--------?--X-T--o---X------------------X----?-----??-----o--B-X?--M-oE---------------EM----X-----
------XX--M------E---?-M--E-B--E----X-B-M---------------?----?-X-------|TT--|----oXET?X--------X--------X-EX-----B-E----TBX-----|--MM-E-?---M-------?|--|--oo---o--------XT-------Eo-----o-B---|--------
-BT------o|T--|--X--?-----------|---X-------E----T-----------X----M--------?----?--X-------|-----o------B---XTM------M--E?---M--T--M---M-|M---|MX------------E---M-----X---------?T--?M|--?-|-----o-|---
--B---o?|-B---T-----?----E-------B-E-|--X----XB-X-|--X-----M-------------o--|------T---M-----T---|-|?-----M------?---ET-|----EB------M----T-?---o|Bo-------o-------E|--|----B-E--|----?o-----E-----?M-Bv
-?---------------XB-------M-X--B--?--M---T--------------------T-----o----------T--M--E-----?--|?----EM--M-BM--oM-----T---?MM-?--M--T-|-------E-|----?-T|E-|--------M--E-|B---------Eo----o-----B--?-|-|f
------B-o-B--o-o-----E|oXX---|--------o---X--B--T---|---B--------T-?-o-----T--------------------o-E---X-------Eo-------o---X-?-----TX----o------------M-B-TX----ooX-T-MT---E---o-------|-----B--B------f
-T-------Eo-EEE--E-?-o-X-M|--------X------------T-------o-?------X--o----E--------B-M-M--B--|oXB-----B-XT----T--------B----E|--X-T--B--?-EoX------?-|X?------M----BME----T----T----E-|MX----T-----Eo---f
--------B-oB------o----X----T--------X---------------E--X----------M-----oXXo----T--B-EB|-BT||M---------E-X-----------|-X-M--T-M-------------o--o-----X-----oEX-|----------X--|---E-E--X--------?----?-f
--|X--M---o---?X-|----T-----------B-X-------------------|-X-------o-X------T--T----o----o---o----o-----B-----|-MMB---o--|----Xo-----B----|---o------E-----X?---o-T-------B-B-|o-------Bo-X-B-TB-T-|-oo-f
----------o-------ET?---MXE----T--T--------|---?-----X----|-----Bo-------B-----------------TX-----oo-----|o-To----T----T--?X-------------?B------B------M--B-|---|------?--B-?------?---M--B--|--To-EX?f
m----o-T----------XB-oB|------------oB------------M--------E-----B-----|-T-----B-M--------To--TE---|?|---------o----|-|E-o----|-----M--X-------M-X?----MM-X-EX----E-o---o--o---B|--M--------------E---BX
X-XXXXX-XXX-XXXXXXXXX-XXXXXXXXX--XX--XXXXXXXXXXX-XX-XXXXXXXXXXXXXX-XXXXXXXXXXXXXX-XX-XXXXXXXXXXXXXX-XX--XXXXXXXXXXXXXXXXX-XXXXXX-XXXXX-XX-XXX-XXXXXXXXX-XXXXXXXXXXXXXXX-XXXXXXXXXXX--XXXXXXXXXXX-XXXXX-X
