-MX-???MBTM-BT---XT-o---X|XTT?BMoX---TB--BX-M|oo--TM-X----o|--T?|--Mo-oB-E-TMEX-?XT-X-|--XT-X?E--M?EBMXBBTM|--E?T--X-MEBE-XXoTM---Boo-X?oToTo?TXo?X-X|--|X-X-oTB-X?o-T---EM-?-E???-EX-T?--X?-XX-X-?BoB--
-TXT-|-?-X------X--T--|TXXT-|-|o--TT?EB--TTBoB-BBTTX-XE?-E-XM?---oEXX-oX-TTToB?XBMo-X-?--BoT?T-EXTEoT----TXo-?o-|-T?MTBT-T?XXBXoX--T-XETo--oB|-TToTo-MME-Bo|E-T-X-MM-X--TTBX--ToEX-?E--?-XBTB|TX|T-TXBB-
-??-X-ToT-X??E|-?X-|T-T-TEXooMoTT-Xo|--XTMXT-XoET-EoB--?XBBB?oM-TToBT--MTT-X-----BETooT-T--T-TTX-B-M-X-BTETXETTEX--oEEXX-Eo-ToB-o--o-X-E?XB-oTMX-ooo-Eo?-o?-XMET-T?--BT-T--XETT|M-|-ooBB-E|TX|BX-|-B-T--
---TTXT-BT|TXT-XTXXo-B---To--XXEX|-EE-TT--E-|T?TXTXBTBXX-X|TT--T-oB----MX|To---X?ToE---EXT----ToB|?-M-T?XoTTBE-E-TME-?-XM-Xo--XB|-M--?T-T-oT-T-TX-TT---o--XXTXM-TT-T-|-Bo-TT-MXoBo?X-?o-o?X-MTTEB|B-?---
-o--||-TT-X?--|E--XX-|E-TXTT-?----EET-oTToBo-X-M-oTT??TTME-X-B-XEETXT-BTo-?T-X?TMXXToT-B-TEM-T|BX-oXX|T-BX-TB--TTX-?XXBM-oTTEoX?-o--ET|-?ToT---BXETX-o-MBX--XoBMTo-B?-BT--|B--B-BEE-?E-E--X?---XB?--?E?-
-?T-||M-BBTE--BM-BEMo?oB-M-o-o-X-o-M-XXEEoTM-M?X--o-EXM?-oBX--X---B?-X-EX--X--T---TBE-ETXoT-M-E-B-|TToT-?--TXET-TEE-MoBXT|TTBB-BTB?-M?X?--EX-XT-TEX??--XT?BTBT-E-MM--X-XTMo-XM-TXX-?XBTT?---oT-?Too-M?--
-TTX?-oT--T?----XXT-T?-?--BToXTTMoE?--?BMBT----TEBoo|MTMX-B-oBMTT?o-MX--TXT-T-BBX----oME-E?Xo-|TM-XXEX--MoXMT--BX-|-B|-T-ToX---oTTX|EB-B--?--B--oTT---X--o-o?T?TTEX--|-M-X--TT-TTBToX-E--TB--?XT-X|?-ET-
-X-B--XT?--MooTMEXoB--oTTM-T-?EXMX--Bo-ooE--X-B-?T-?-Mo-EX-XT|-oT-B-XTM-M----TX---XTX?BTo?--T-X-B--T-o??XME-TTTTTB----oB-?ETM--o|M|MB|TXEo---MT-B-Xo-E----T--X?oBo--TX??BTETo--oTT-?|-TT?-o-?oo?-|-oTo-v
-?XE-?oXMBB-TooE?-E----X-TXTXTE--?-?oM-oTBT-|-MX--X-BTXTM---T-o---BE-oB-o--?oX-??-o-X-X-ooM|o--XB-XB--E-BMToT--BToToB-Xo--|XBoE-MT-oXBo-To-XoTX---B--TBBE|o--?XBT-M-E?MoTToTX-oE|E-BT-ET|X-oooBX--BT-B-f
-----To-Too-T-TTo--XT-Eo--T?-EB-??TE--X---oTEooEM-o?XT-----TE-?TXTX?--X-BT?-E??oBToT-o|TTE-MoTXXo--o-TTXo-?--TB?--TXBTo-ME---T--BT?oT--E?B--XXX--E-E-X--TM-E--BMTBXT---X-XT-Xo-T|X-X-?oXEB-BXMXTETM-TT-f
-B--Xo?TXoM--?EB-o--o-BX-|-MMB--TooTE-X-MoBTTMTTMXTBX-ET------TT-B?T-B-o?--XTX?X-ETTX?---TXo-TXT-XXX-T-oET-ooo-|ooToTT-T-BTMoXT-oT-TT-----X--?|TMX-MoMB-TEo?T--BXTEoE-|--B-X?MT-BX--XM-oo--?TETBB-M---Mf
-M--Bo?XoTET---TTEo-o---oM||--MX---TTo-MTT-oMBBT-X?XEXETBo-T-T---B--To--XEToBT?TETo-oo-----?-TXoTX-TTo--EBE?-T---B----?|--X-T----T-?oXT-oXTo--XTM-||-----o---oE--X-X----ET-M-B--B-BTT--o-TT?-MBT?-TET-of
-MooEX?-EoX?B-EB-?--B?BMX--X-BBMM?---|o?|-E-o-ME-XBoXB?-XX--??-X-o------BB-B---X?B-XBM-oMEXX??----XM--EoMXXME--M-M?ooXEXoMM-XBX?M-MEo?-?B---?Mo-oTB-X-X-X-oEBoEo--M?BMXE-X|-o-B?o-o-B-o-BEo--BX--XE--E-f
-?-EXX-X?BBBo|B---X--X?XXX--MM--B?-B-oX-|?M?E-ooMXXX-?XX-B-|X?-oMMMX?BX-B-BE--o---XXo-------oEo-X----BBBXB-o?oBo-|B-o--o--X-Bo-X-Xo-XMBBB?oB-B-B?-BMo--B----MX??B-?-Bo--E-?XoBoB-?TM?-XB-o-oB??X-X?EM-of
mo---X-o--Bo-?-B|X?-MX-oE--E??--BE??oBoo-XB-o|-o--?EooB--X-XMB----?-T--XoB-oo-BXXoo-T-oXBXEo----?XBMXB-Xoo-X--??EXE--X-oMo-ToBoXB?-X-B-BBXX?-oMT----??X?XXXB-BB--ooo?-?o-EEX---o?MXXoX-X?EX-XX?--XTEX-BX
XXXXXXXXXXXXXX---XXX-XXXXX-XXX-XX-XXXXXXXX-X-XXXXXXXXX-XXXXXXXX---XXXXXXXXXXXXXXX-XX-XXX-XXXXXXXX-XXXX-XXX-XXXXXXXXXX-XXXX--XXX--XXXXX-XX--X-XXXXXXXXXXXXX-XXXXX-XXX-XXXXXXX-XXX--X--XX-XXXXX-XXX---XX-X
