-oE-B--|-T---M----------------E----X---|?-XE--o-M-?T--X--|--|------BB-X--|--B--T-|MXTo---B-T--MX--X-X-oB--M--------?XX--B---EX-TM-|XT-B-|-oM|---X--|--X--XEX----------o-Xo--X|-|--|---?--TT-X-M----BXo--
---X---------E|-E-?---T--oE-o---E---B-Xo--M-----X?--T---o------MT??--?T-Eo-E--------X--------E----oE|----T-XT--oo--XEX-E----ET-|B-B|---T-----X--B---T-BXX----?X------B-E-|-T---oo?-?--X-T-?---?M---?----
---o?M-o--XX-E|-M-----?|EXB---TM---BB|--------T--------|-|--ooB--E---X-BT-B--X-------oo--X---E?--T----XX-M----o---X---|-----oE--o-----oB-MX-M---??---|-----Eo-?--------M-?oE--------o--oo--MB----o-X--T-
---To---B---M---o-E?----T-----M--|-o-|----B|-MB----|-|-|-----E-o-E--|----X---M?o?E----M-|?-?MoT------X--To--TTB----Xo|-o----M?---BT----B-o--X|o-T-----EBM-T--T----M-B|-?M|--|-EX--E-T---?--|--X---o-----
-oT-?--M--------o|o-----o--?-T-M-T|?-----?----|-?---X-BXE--|B---?-o?XE|-E?--X---o-B---E------X-|-T---|-------T-X---o--?-X-E----E---B-|-M-|---TB--o-?o?-B||--?|---B-?-E--------XEoB?|--EEM-TX------X-----
---oM--X-----?-T|---?-o|X-E-MX-E------X----?|--Xo-TB----M---E||-B--?|---M-?-------M--B---E----o----T?M-?E?XXM|----oXoXM-ooT-X--------T-X-E-oE--T------?---T----o----E-X-oE----?T-------MT-----E--BXB----
---B-?B-TEX---------------|-E-E-------|M-------|MB-o-----B?--?---TEB-?-Xo---B--o--|---M-||M-E----|-M-X----B--?|---B-----ME--E--|MXX-o--T-M---X---??-E?------|M--------|--XXMXB-X--------B-|--BoT-M-?-M--
-------?-----|------B-T----oB-o-----------E-EETo--TM---XB----X-----BX-|-M?T-M-o--BT-E-M?|-----?-----|-?-XB-o---B--E--oE-----|--M---|--X---M-X--|---E--T-|---?---XT??--X-BT----------E--?--M--X--------Ev
-?-ooE--B|--|TM----|-EEE-T-B-?-|------X---T??BB-----oBMMX-X---B-oM------|----M-oo----E---T----M----XE?|oo---B--------EBM-X---?T--|?--o--BTT-TX-T-----M--o?B-M--X--MX---X----||---X--o------M------|--o-f
------B------E?---o|--XXB--------X--?--X-------T?X--T-oB--B--oE---------E--E----B-----E-T-X--|T-T-B-B-----TM-oM----M--B|-------??---X-Bo----E-?T--E--T-E--o-X?B-|-o-|-?-oM--------B---TEET---?---o---TXf
-B-----o---|-E|---B--|----TT-TX-EE|?---|X----|-----T--|----T-------------|---ME-?T---XTo--?---o------T------MX--oT?---M-?------X--oM-||-?----XE-T-T---------E---------|--------E--T--oM-----T?---E---B-f
-B-----------------E-M-ME-|B-BE-E-o-----B--TE--------?-X--------B-M-oT??|---T----------oo-oTX--B-?oX--Xo-BX----MEB-XETM----------B---BM-----B--X--M--M|T----Bo-T----Xo-o-o--|---E-|B--M??-------B------f
--?|---XT--|--B-X|--E----------|--X-M?o-o--oMX--TB------|--o|----E-o|-----oT-M---ET?--?-T----X-E-?--|----X-?T?-----B---|-?-X--B?---?------TT-|-E------B---E-|---?---|----M-E--E-?--MX-T-o---X--T------|f
-MX|---T----|-----?-----M--MT--?-T-TM--oTT---oMT-|-o-----E-T-----oo-T-M----||X?----ME--|-E-?--Eo-B--B-?------o---MM----TT--?-o-----M----X-T---B--|-B-X|?---?B-EX|E--|---M----|--T------Bo-B-?---?--TX--f
mE--M-T--Mo-BMX-XBT?--?M------------?T---o----oE----?-B--E------T--T-T----o---M-?------?--T-------E?-B----o---------BT---X-|-T-------T----TM---T---B?-----M--M-T------B|---------M---B--TMoE-?-------EBX
X------------X-------------X--X-------------X----X-------X--X--------X---------X-----X-----------X-------------------X---X----------X------------------------------X---X--X----X---------------X-------X
