--------------E-----X-o--------------------B--o-------E-B------------?-M---------o-----B--X-B-------?----o------?-?-----E-------------?----------X-----------BBX---X---XX--|------B--------B----M-------
-o--|--BX----o----------B-?--X-----------M------o------B---------?--B--M-o----o-M-------|-----------M-------o---------------o---ME---X----X---XB----------BMB-----BX---------B---?----?X---B-T---BT-T---
-E---o--------?X----BX--o--------M--B--X--------M--?-------T----------X-------X---X--X----EM-------E----------T-------------E------------|-----------X--X-----X--------oB--E---------E-?--XX-----o------
-XM---T-B--X------X----oo-M----B------??-----------E?-oM---------o-----B--X------o-----------M??-------o---B-----------?------|------X--?-B--------B---------------B--?---?----------------o----T-------
-----------B-o----o-------E----X-----X-----------M--?------B-M---T----X?---|-E----X------------o-------E-T------B----|----------oX-------X--------------------B-----------------E-o----E------E-X-------
----X---------B-----------?--------------oo-?-------X--------?--X-|B-----X---E---|-B----X--o---------B--X------?---o--E------B--B-------o------M?-----BBXB---|o--------------E--?--o--------------T--X--
--|----B--T---?-------------|---?------?--?---B--?---|XM--------E--?--------------M?------?----M-------E?----E-T--------o---------o-------?o--------MXX---------------?----|-----------o--?-T-------E---
-B-----------B----E--o-B------------M-|------T-----------------------------|-------------XM--XX---------X----M---B------B---------B---------M---------o---X----M--------M-----o-----B---T---B-X---|-?--v
-----?----?----------------------------T--E-B-----------?-|---E-?------?------?--|-------------Eo-----Xo?X--?---X-------------------EX--------o--X----X---------------------------------------?-----X--f
-------M-----B--------T--X------------X------------------------B-----------------o----------Mo----o-oM---B-B----------o-----M-------------------XB-------------Eo--?Mo------------------E-M--------?-o-f
-oT-----B------T----o--X----?-----------o---o-BB---o-----X----|----|----------M--------?-------?---B-----E----------------------------------?-B--B-|---B--E--------M---?----M---?-----------------X----f
-o----?BB-?-----------------------M------------E---|------oX--M------T----?----------T-----------B----E--B------X---|E---M------------?--------------------o----------------B---|------ET-----|----B---f
-----------M--E-----oX------o----------M-o------------------------M-----B?------BXo--------------?-o-B-M----?-|?---|-B--o-M-----?|M-----X----------|-?-------X--------E------------X-----------B---X---f
------------?-----M-------E-o--B-X----o-----??--|---|----EX--X-----B-X--B--X--B---X-------------oo------X--------?--?E---------?--X----------B-M-o-o-------?------M----B---TB-----------o---X-----B----f
m--MTX---------oM----X--M-------|---B----------?---E----------------------o-o----E--o--------|--X-------o-o--------------B-o--M----------------------?-|---o------E--B---------------------------B--B--X
X--XXXXXX-XXXXXX-XXXXXXXX-XXXX-XXXXXXXXXXXXX-XXXXXXXXXXXXXX-XXXXX-XXXXX-XX-XXXXXXXXXXXXXXXXX-XXXXXXXX-XXX--XXXXXXXXXXXXXXXXXXXXXXX-XXXXXXXXXXXX-XX-XXXXXX-XXXXX-XXXXXXXXXXXXXXXXXXXXXX-XXXXXXXX-XXX-XXXX
