--B-------oo--XX-------B--------o-----------?-X-----------------Bo--------B---------------oX----o---?-----MB------------E---X------M---|M-------------------XBB-----T-o-------------X------M---?---o-TB-
------E---MXXB--?|------------X----EoM---?-----------M----------M---------------------------------------B--X-X--o-o-------X---TT-----E-----?-----------B|-----------?------------X----E---EE-E----------
----------X--------------o?----------X---o--------E--?----B-|o----E-M-----B-------|?E-------B------X---?---M-----E-|------|-X-----X-----X---------------------X--|-----|-X?B?------------------B----E---
-------B?-----------o-oX-----------|------------?o---X---MB-------|--|------B|B-------X-B-o-----------M---------|--------------?-o-------B-?-----------M-----------B--M-----------B------T--------------
------?--X--------M------------------X-------------------B------X--------B-------o----B-----------MT-----M-------M-----B--B--o-?--------M-X-?--BXTBB------X--X---------------|----------E-B-X-----------
-----?-EB-?------Bo-------M-E-----E-B----?------E--E------------X----M-----X--B------Bo-X--?B----------B-------------TB---------E?---E-------------B-----------X-----?---B--------------T----?----o---X-
----------E-B-o---------B-?------E-XB?T--?-----?----Xo-----oo----------M--E--B-XB------X----?-----X-X------o-----X-oX--o|--------X-------XE--X------B------EX-----------o--X-----B---B-----T------------
-B--??--X?----M--------B-------E-------------oB-o----X------BT-XE----X--BM---------------------------B-------X--------M--M--B---X-------B--------------X--------M---------E------------------------EB--v
--EM-T-------T----------M--------M-------M---?--E-X----o--oM-------To--X--B-----?-|-----------------------X----o-X-----B---------X---------------o--------B?-------M---X--o-o--M-------?-B-----?-------f
--?-----T?--o-?-----o|-X--------E----X----X---------------E-------------------E-----------------------B-----------TT------o--------------M-B---|?--E-M----E?--------B-BXX----E-X-X---?--?--M-|--------|f
---XM--o-X|M------------------------B-BXB------|o-------------T------E----B----B-E------------o--?--?---B|------------------?----X---M------|-----X-|---------E--?---------------------X-------M---M---f
------X---------B--------------o?-o----------?------T-------E-o----------------B---------X--?B----X-X-XBX--------E-------X----o----------------E-------B---oM----------X-----M-T-------?--?----B-------f
------?-----?-X-------|B---X-----------?------X-------To---XT?------X-----X--B---------M--X---B------B---M--?XB-----T-o----X--T-------------E--------B------X-----o--EM-?------------B---E----Xo--X----f
---------XB--T-----------?-----M-------------------o--B--------------T----?-------?----------?--X--M--------?-|---------E-----M------------EM---------------M?|--------------o----X---X-----MEB-------Ef
m--oX-------------------------B----X-----|----X--BE-----B----------------------------------M--T------oX----E---XM--M---|---------E------B--Eo--------?--X-M----------E-X--------------B-?-----M-----B--X
XX-XXXXXXXXXXXXXXXXXXXXXXXXXXX-XXXXX-XXXXXXXX-XX-XXXXXXXXXX--XXXX-XXXXXX--X--X-X-X---XXX-XX-XXXXXXXXXXX-XX-XXXXX-XXXX-X-XXXXXX-XX--XXXXXXXXXXXXXXX-XXX-XXXXXXXXXXXX-XXXXXXXXXXXX-XXX--XXXXXXXXXXXXX--X-X
