----EX|-B-E-------oBBB--T?|o--|-T------X-----o----BM----o--------------------------|M|--?-||----M-----------o-E-EEE-----|T-TT-X-----o-----X--|--M-TT-E---T---------T----------B-M-------T--------o--BT--
----?-B----o-X---?--------E---o--------T--EE-----------------Mo---E------X-?--------o------T----E--E-T--o--------X-----X-------M---------T-B---o---|-XX--|----XX--|o--o-M---X---|XMB--------oo----------
-MM---E-----X--------XE-oM-MM-X-----?E--------------------|--T-MM------E-XB|-BM--?--------B|--T--E--To-----E----?-|X----?|M---X-o-X--M---X-X--o------o-----------------M--T----B--X--------|-?T-|----E--
--B----o---|X|----------ooX-M?---?T---B-?M--M-------BX-----E---o----?--T--oM--T----|E?-X-B---XE|---o-------B-------o------M------|--?--|M---------o---?------E-M?----?--T-B--?----------?T-----o--M--Mo-
-?----X----------------|-----|X-----oTB-------------B-----MB-?--o---M----o-----M--X----E-E-o------ET-------------?--T--ME---?--T------------T-----XB-o---?----------X---TM---o--o---o--M-|----|-oB------
---o---XT--?T--X-B----E--------E--M-M---E---?MX-?-BB-----X---??--------------B--?----|B--------E--------------E?-?---T?-T-XM|--T?---B-M-----M-X---E-M--------X---------o-|-X-------B-------T------------
-MB|-----?ET-------?|--M--?-o-|-|M----X--E--BE-----o-?----T------------T-------o------X---o---T--o----M-----X-?--------B-----M-TM---TB--------E-MBM---E--B----M------MMM----X-B-XE-----M--o------Bo-EX--
-X----B--|-?------B---?--E-BX-o--|X-|-------E-------o|-----|--o---E-E--X--------MXET--|--?-------M-----B--------B---E-----X---X------E|-----|---oT------X---M-----------TMoo-T-XX-E--?E-M---Bo-M-------v
-E-----T-----T---TM?-B---o-T-?--X---||?-|?-E--MB--------ME----?---?E------|-E---T--E-----|-X--------X---------EE--T-M-----?-X?B--X---B---|---B-----B--oE-----E-M----XX---B-MX-M--?--T-?--------B----TB-f
----?--------MMooB-----oX----X--E---TM----|-----------B-------------E-TM---|------E-?--T----TT-o--o?M--------MMT--?--|-----B--ME-B-T---?--?---|oE---?--M|---?------B?--------E-E-X-B---T----?o-M-------f
----|-|-TBoX---o----T-------M---TT---EM--E-----------------TM-|------E----E--B---E---o--M-XE--XX---M------|M----------------X---X-?----oB--?M?---T---B---?-o|-B-E-X---?---|-To---?-EX-MX--------E-E-|--f
--------|oB--|--ETB---------MMEX?-T-B---M-?----o---------|M--------o---M----o-TT------|E-------|-ME|B----------||---B----B------------------T-E---M---X-?-----B----M------E-X-MT?-------------?-T-?-X-Tf
-X--|---|E--M-|--E---E-|---------BX--------B-?--B-o-M--M------------T--o?----M--M-o---T--?--?----E-BBM---------XMT---TX-X----X--T------o----Eo---|------?--o?o--?-M--------??---?--E-----?M--B-----?o--f
-------T-------M-------|-X--E----T--E---X-------oo------X-----M---E----EMB|-----B-o-X-----o----------E-|E--------X--EM--E-?X-E---EX------o------|Mo--------------|-B-----T----To---------?X------EB----f
mMEBX--?--E-E------|-----T-M-X-------T|-B-MM----|----M-?--------------------X-B-X-------?-|-------TB-------E-------TM-----o-----T------------------|-----X-----B---T--|------E--o-X----T--------?-X----X
XX-XXX-XXX-XXXXX-XXX-XX-XXXXXXXX-XXXXX-XX-XXXXXX-XXX-XXXXXXX---XXXXXXXX-XXXXXXXXXX-XXXXXXXXX-XXX-XXXXXXXX-XXXXXXXXXX-XXXXXXXXXXXXXXXXXXXX-XXXXXXXX-XXXXX-X-XXXXXXXXX--XXXXXXXXX-XXXXXXXXXXXXXXX-XXXXXX-X
