--?-----------------------------X-o-------XM--------------?-----------o--------M--o----o-----------------X------?------B----o-----------?----------------o--B--------------o--------------------M-------
--X---o-----B----X?--B-M-X----X---M-BX-------X?------------------?-------M--------------B----o----o-X--o-B-o----------------------o----------?-----------------------?----Eo-oX-X---M-----------o-------
----o----o------------------X?--------?--X-----B----------M--XX-----?o------------B-------X?---X----------BX---------------------------------------------o---------B-----M------------?------M------Eo--
--------------M-----?--o------E-E---------?X-------------o------X------?----o------------X----------M----B-------------E------------------E---------------X-B?--oo-----------oX--M----------X-----------
--o---------X-----B--M-BM--X-----------------------X----------X?-------------o-----------------Xo----E------?------oX-------o--XX-----X-----------------E---o---------E---B----------MX----?----------X-
-B-o---------B--------E-------?E----------------------X-----o--Xo----X--E-------B-o----X-------X----??X-----o-B-B-------------o--------M-oB---EE----E-----------X--o----M--X--o---------X------M---E----
------B----?---------------?o--EX-----o--X-B---o-----?-E--M----E----?---o--------X---M-B------o------------X-------B-B---?------------X-----XoE-B------------------------------------------XB-----------
-o--X-----------E---------------B-o------------------------oM-----M--Eo?-----------o-----------?------?-o-?--M-------?--------------------------B-----X------o---------------X--o----------------------v
--------X-?-------------B-----------E--?-?--X------X------B-----------B-----------------E-o-M----------------B-----E-----X-?---------o---------------------------------?------o---?-oM--oB---------X--Bf
-----X------B-------------o?---E----------------?-----o---XX-X---X----o--X----E--------?----X---?----------ooB---------X-B--------X-------M-?-----------B--o-X-------EM---M------B-------------X----X--f
--------------o---?------------X---X--------X?-M---E-oXoo-X----------------M------------o-------------X------E-------------?--ooX------X-------------------oB---B-----------X-------?------------------f
-B---------X----XX-------X-B---------B?X--o---M--?----X--E---B----X-o--------?----B--------o--oB-------------E--X------------------XB-B-------o-----------------?----------M-----E--------------------Ef
-------T-?--o--?-BToE-?BT-oXBBE?----o------XT------Eo--MTX-----X----E--------T-T?T-B-T----TT-TX--T-----oTT-------?--T------?---E---TT-XTMo----TX-?----X--XE-T-M---T---o--E------T-?T?-T-T-T--ME---T-T--f
------?|-----E---T------|T---M--TBT----X--o-|---T---E---|------o---M---|o----|-|-|---|----||-|--T|?T---o||------oo-E|--------------|X-----?-o|------E-X|-T---T----|--|MX-X---T--|--|--|-|-|T-------o||-f
m-----X|-----|E?-|------||-T----|-|--E--T---|o--|-E------?-----------X-|--X--|-|---T------||-|T-||-|---M-|B---E----XTBT-----MB--o-B|-XXE-----|M?-----XT|-|---|E--T---|E-----oX--|--|--|E|o-|--?-----||-X
XXX--XXX-XXXX--XX-XXXXXX--XXXXX--XXXXXX--XXXXXXXXX-X-XXXXX----XX-XXXXXXXXX-XXXXXXXXXXX-X-X--XXXXXXXX--XXXXXXXXXX-X-XXXXX-XXXXX-X-XXXXXXXXX--XX-X-XXXXXXXXX-XXXXXXX-XX-XXXXXXXXXXXX-XXXXXXXXXXX-X---XX--X
