----MEX---?----B-------------------------------------------Bo-----------o-------E------------------------------------?----------------E--------------?----------o--M-o-X--B-------------o---M-----------
---Xo----X-E-------------X----E-----B---B-o--?----------------------------E--------E-?--oX----------------------------?---------Xo------------o--M----Xo----X--------------oX-----------B-----------?---
----o----M-o---XE?---------B------------------------E--B-o---X---------------------?------X---XE----M------------------------------------M---E-----X-o---o--------E--X------B------------B-------E-?----
----------o--------------------------X--------------M--o----X------o--------------X-M------B-------------X-------X---X-----M------MX----------------B--M--M-------B-o----B--?-----X---------X-----------
-X--------BM-----B-----M-----X-X---------------------------------------------------M-o--E---M--E-?----------------B-----X--------E--o?------------------------o---------------B---X------------------BE-
-X---o------------------o--o-----?o------------o------------B-----X--------E-------?-----------------X?----------?-o-?----X-B-----o-E------------M-------o----------X-----B--------Xo---?----X-------o--
-------o-M------X--B--BB-----------E-------X---E-------o-----B--------o--------------M-BB------B-o----------X-------o--o----X---E---?---?X---------o-----M-M-----B------B----o--??MoB-------------------
---B-------o-------------X--E--------M-X---------------o-----E---?X----X-----E-?-B-----B-----?----B---o---B?--o-------------o-------------------X?-------------EX----------BB----------EB----X---------v
--------------------------B---------B----X-------X?-----?---------E----------M-o-o------o-----E-----o-------X------------X-----------M------------B----o--MM------------------EX-----------X------X----f
------------------------?-X---o----o---o-----X--M-------M---?---X----B----------------------------E-XB-----M-E-------------?o--?--------------------------------------------------B----E-----------B---f
------------E-------------?--------Mo---ME-----M-----------XX-X-------E---------X-------o------E----------X-?------?X----------X-------------o----E---------B-------B--------?--o-----?o--------M------f
---X---M----------E--------o--------?--oM--X----BE--------o-----BBB----------B--------oX-----------------?--------E-------------EM-------X-?-----o---X------------------------?-----E--o------------B--f
-T--oX--------TX|-XT----o-M--o--XoT-T--X-------X----TB-T---o-E---BTo-BT--T---M-TXB--X-T----ooB--BBB-?-oB--T-E-----MXo----B-T-E-X?-X-o-?T------oo----o-BE----?---MT-?--T--MEX-T--|T---T-B-T-o---?XT----Mf
-T---T-----B-MM-M----|-----T|-?-TT--XXX-BE--B----B------o--Eo-?T-------B-E-----T-?-X--------XTTo-X---o-?-TT------XTT-MoT-X----B---|-T---T-XX-To--T|-B-----T--------o-ooo--X-X|X---X-B---X--------T?-E|Xf
mXX---T---XX-TTE-B-o?-M--M--?----TB--B--?-X---o-oB-B---Too---T------o-?X---?B--oMX-X--o-TT?M-MXXT--E-----T--?---o-XX-------TBMTB-To--o-XM---MX-X-----B-oT--o-M---oTB-B---Bo|TT---T?ET---B-T--?-o--Xo--TX
XXXXXXX-XXX-XXXXXXXXXXXXXXXXXX-XXXX-XXXXX-XXXXXXXXXXXXXXXXXXXXXXXXXXXXXXXXXXXXXX-XXXXXX-XXXXX-XXX-XXXXXXXXXXXXXXXXXXXX-XXXXXX--XX-XXXXXXXXXXX-XXXXXXX-XXXXXXXX-XXXXX-XXXX-XXXXXXXX--X-XXXXX-XXXXXXXX-XXX
