-o-EoM---?BXEXoXoBEMBX-E?B-----?BXo-oX-X?X--??-o-?--oXEoM-ME?EX?o?MEMXoXo----?-M--oXBBo-XoX?-X--Mo--ooo-oX?-----MM-o-E---|-?EB-XEMM?Mo?--T-Xoo?-M---M-||?-EMX--B-o?----E-XE--E-?----MXoEXT---?X-o---XB--
---o-oEB--EToooMoX-E??--BooE-??---BXEoB-XoBE?X--oB-?B|BEM--?--?--MT-T-oo?X--XB----o-?M-XEXo-?EX?M-o----BT-BX?-?-M-oooo-E?-X-??-Xo--?----X|---TB-T------o-MEo?-E-B-?----?--?Eo---MEE|--E?oEEBBX--oE-oTMB-
-o-----?-----ooMoo?BM|--MXMB--o-BXB?o-BBX?EM----X?-?X-MToM-XXX-----X-o---?o?X-B-MEo|BXo?Xo----?B-o------EXoo?o-Eoo--X----BX---X--X??--B--B-M-MXXX-MXX-E??o-o--MXX--M--X??--EBo-XMX|-o-o-BX-?-o??EXX-Xo--
-o--Eo-oBB-X?oEXM|--XB-EM-XBX|?o-MXB-?XoooM-XX?Eo?E|?B-o--?X?MT-??----M--EB-X-MXBoX--X?oo-?XXB?EoXE??o-E-?B-X-o??--MB--E---Eo--?X-M-oX?--BXM?-XoX??X-?--EXB?B?--M--X?EXBE--T--oB?-?--EMB-oX-M||-MX-?E---
---?---X-?-?--X-o----|XX|X-MooTXBXo-MM---XBX-??EE-M---?X---o--X|-B--oXE----E-o|oME-MEX-oo|-M-BXEXXM?ooXoTo-X?-BTBXM-XBX--BM??---?|BMB--MoT-XX?X---X--oX-o--B-?--XB??--XM?|XoT?-oT-M--MXXXX-E----XMX?XB?-
-X-E-o|?XXB---X--XBXE-XBo?-MEoo-o-?ooo-?o--oXM--Xo-o-X-?-X--MEoX----TB---XX-X-B-M---EXX|--?Eo??T|X--o-?-B-oT-XMX?--X|--|-X-oX-T-MXXoXE---M-oT--???-XE|-o-XB--o-?EBX?oM-XX--oXo---XX?X|B---ME----?-XEE---
--M?MM--BX?XX-M--MB--|-Xo|--oBEXM?Xo----?-?--oo?ooT-?-BBX--BXoo---XBM-ooEoM----oX--?--?o?---XooXEX-MXM?--EoX-Xo------o-?ME---??-------B-XoM-X---XX--E|TBooo--?-??-|?XX-E?-XBE|MT-o-B??XB?-?---BoBEXo-E--
-oXoX--oX--o--X--o---M-M---Xoo-M?T|Bo?o-?-oo--E---XB-?Xo-o-oX|-E-?------M-E?--M--?X?---?-XM?B---?|?XEXBTX-o-Eo?MX?--X??--B-?E-X--|-o-o???-EMBXXMX-B?o??XEEXMoXo?---|-ToM--oX---?M-|-o|-oX-E-oXo-EM-----v
--?-----M-XooXXBM-B--TEoooM-M--X--?MM-o--o-?XE?E----|X-XMX?-|--X?|-||-?B-M-?oo?oT-?-X--MXX---?-EBE?-?B---?--XM--E-?-X---oo?To---oX?oXXMo--o---X-?B--oMXTEB--oXE-|-BBX??o-?-BBo|-o-X-|--o|XE-MET-EM|X-??f
--M--o-XMXo??o-Eoo--EX---MXoM-B--oMXXX-?----X-oBo----Xo---BB?-M-?-M?o---?XMEE?X--X--oB--|o---B-Mo-o-B---Eo-oEo-oo-Eo-o?X??E?--E-o--?B-Eo--|E--o-X-T?--E--MXX--TXo---oM-Bo--?|XM|XM?X-o-XM-?-XEXX??-MB?Xf
-o?o?--?-B?-E-X---XX-MM--E-ooooX-EE??X--XoX|X-E??B?EEMMB-E---?---o-EM-?-?---o-?XXT?E-XXX?-M-XX?-Xo?ooX-X-o--M?B?-o-o---X-?X--?----?--M-----?EM??TX--MXM-o--|--BB|oooXo-MX?X?-EXoB-MoX-TEMMo?o?EM-M--MoBf
--Xo---XTEB--B-BXM-??X-X?M?-EXBBXoMM---EX?XEXB-ooEoBTo-o?--BXXBEo-oX?---MX--MX-MoB-?M---??MoE-XX-M?XoooX--X-T-M---X?XX--Eo?-oX-E-Bo--XXX?X--XMooE--X?X?--B-?-|?o-X--BXX-X-oT--?-oBMBE--BB?--X?X?-BB?-o-f
-|BoXEE|-|-B-B-T?XE??T?X--M-?-o-E-M-B-o?--?o-oEM?B--BXBo??XEB?BoBX-XEEXM??---oo---MBBX-XXXoX-Eo?MBMMTX-?---XX-oToM?o--M-EXXME|---?oB-BXoMB---EB?-XBB-TXX-??XM-X-M-?-Moo---|o-E--XBM?oXoooE------oX--X-Bf
-X-X-o-o--X-TM?--oX|-X--oo-B-oXX-Xoo|E?E?-oB-?--BBB-XMX-BXX?-XXX-B-ooEoo?EXBo-B?XMoXBETBo--?oBooBoMB-BX-B|o??BXoBM?-XXXEoX??-ME---MX-|M-XBXX?BB?o--o--X?B---E-BBX-o??XB-||o|?------XB--X--?-oo?B-MM--XBf
mM--EoMo-E|B?-XXBoM-Xo?EXM-BBT--X?--------EX-oBBoXB--XoM--?MB-M-X-oEX-EX?oXToM--X-?BoBM-???-?oX|X-BBB--BX??XX-oX---o-T?oB-X-?-?BBEBo--E-BBTXXXMooEXXXMXXToX|-XB-o-E?BX---?B?-oXXoBoXM-B-B?X---BB--BTB--X
XXXXXXXXXXX-XX-XX-XXXXXXX-XXXXXXX-X-XXXX--X-XXXXXXXXXXXXXXXXXX-XXXXXXXXXXXXXX--XX--XX-X-X--XX-X-XXXXX--XXXXX-XXX-XXXXXXXX-X--XXXX--X-XXXXXXXXXXXXXXXXX--XXXX-XXX-XXXX--XXXX--XX--XX-XXXXXXXX-XXXXXXXXX-X
