--------o--X--B-B--------M------B----------B--------X---------M-------------------E------X-?-----------------?--------------------XM-----M--------X---?-----------o--------------?--B------------M-o--B-
---o------o--?--------------?------------X--------X---B--------------------------------------o--X---X-?o--------o---E--o-B-----o----------??-B?-------M---XX-----?-------------?--oM--------------------
----------B-------------XEX-M---X-------?-BM-----------X-Mo------------------------o--------------oX----------B---------oM-M-?----B------B----M-----M--o--------Mo-----------------------------------o--
----?--------M------|--MM-------------o----o-o--------------X-XX-------------o--------------E------BM?---------EX----o-------------------------------------------------------------B--------E-?---------
-----?---------o--o-|---X---o-X---------M------X--------X---------------M-----------------------?B--o------M---M------------------------------?-------?o----o--------o-o------M-|-?-------M?--------B---
--E-?Mo---?------o--|---TXB-----------o---E--------------o-----E---o---------X--------X--?--XE--o-------------------o------?-?o---------B---------o-B----------------o-------B----------B--?--X---?-----
---B---X---------o--|X--X-----o-B--E----------------------------M-----------T----X--M---------o--?-----------M---------------------------E-------B----X-------------------X-M--------------M--?-----XE--
----------------?---|--E----X------B---o---------X?--oX----o--B---------M---o---X-X-----B------XM-------------------o?---B--B-EE---------------|--------------------X------M-----------------X---------v
----X----o----X-----|-o-o---------M---------o-X-------------|----?-E---------B---------------E---X--------o------M-------------------------?o--|-?--o--X---------?-B-X--X-------------B----------------f
--------X----M--X-o-|-----------------?--BE-----o--o-------M-----?--B--M------------------------------Eo----o---?----------?---BE--|o----------|------------?--------oME---B----------------ME--o------f
--o----------M----X-|------------------?--Bo---o-o-------B--------?-------E-----B--------?-----------B-------B-----------------?-XM|M-o--E---B----M-X--X-------------------XB--------?--ME-------------f
---------E---E----X-|----X--B------B-o-E-?o--------E--?-o-------B-------o---?E----------B--X----o---------------------?-M----X-----|-o---------|--------------M----------|-X-----?-----o-----X-------B-f
--------B----XB--EX-|-T-X-E--B-X----BTo--------?--E----|T--?-TM-----X--TXBEoM-T-o--XTM-----T-------XM---MT--?---o---M-T-M-o-T---B--||o-----E---|---B---B-M-o---E---T--T--|--o-B-X--o--?---?---?-E-MT---f
------B-X--|X-----X-|-|--T?----|--------o-E----|--|----||--EX|----X--T-|---X--||---E|-T--o-|-------------|B--T---X-|---o---T|-o----|-B---|T---------|-T?---|-|---M-|-----|---|--|--X-EBo-----XT--|---E|f
m-----o--|--X-T-X---|-|---M-?|--X------XT--X--E|--E--o--|E-To|--------T|X-E-T-----o-|T|--X-||-?-----XoT-----o|----T|--M--||||----M-|--B---|-|--|--|---|T---TM|--|------XE----|--||-E--B--T-E-o-X--TM--|X
XXXXXXXX--X-XXXXXXXXXXXXX--XXXXXXXXXXX-XXXXXX-X-XX-XXXXXXXXXX-XXX-XXXXXX--XXXX-X-XXX--X-XXXXXXXX-----XXXXX-XXX-XXXX-XXXXXXXX--XXX--XX--XXXX--XXXX-XXXXXX-XXX-XXXXXXXXX-XXXXXXXXX-XX--XXXXXX-X--XXXXX--XX
