-T-?--oT|X-|ET-X-ooX-X-B--BT-|-?TTB--?MX--o--oM----T-|XX-|X|XBXXoBoXEB?EX-TBX-?oX----EX-EBM-XE-TB-X|----B?X-EToET-o--XTE---X-o-X|o---?E?--?--MT-|TXXXTo--B--?X--To---o-TX---oETooM-E--T-TBT-MMMToT--EB?-
-|--MX-BX-MXo-T?To-BX-??|T-M-|-TE---E-?XTX-T--oTTo-EToo-B-ETXTB----oB--M--E-BX--?---oo--EB|XX-MXB-TXE|?-TM--?MMEoT-TB-|-M-T-|XXo-?--?--ToT??-MB?-X--BoXB?To-|TTXT?-E|T---oTEX?--o-TB-?--ETX-BBoX?XT-TTB-
-o-TBT-|-T-Eo--T-B-oM-oTT-M-|-o--oT--B--?oEX---B??MMTo-T--|-o--|--TMX--T--o-EXEBMXTX---TE?-o?-T--EMBTTE-MBTT--BTMo-XoXX-oT-XT?ME|-|BXET-B-BoT--TTB----T?T?-TEo--TT-BB---TBE-----?-TB-T?-XM---XTXT-XX-?--
--XTBEoo--Xo-B---MT-oX-o-|XM?BBBMBToT-Bo-?BT---TTT--?o--XTE-ToEXBTMo|TXo---o---To|XM-X--E--BTTT-oo?T?T-TTE|?X-|B|?-XXEBM?To-----TXB-?TMMETTo|oXE-E-X??MTB?ooXXoTBXT--XTT---XT-?XT--||--|?-X-?EET-TTTToT-
-oBT--ooX--T-XX?TT-o---X-TXo-|-o-o-XoXT?X-TXT-TT--?BoM-|-X?-TBTBBXBT-BBBMM?-|?oTTTB-E?T-T-BX?T-T--EoEoo-T-XTB---|oo-E--EETXo|-TM-o--o|-?-T-EXX?TT|----T?X-BTMToME-To?--MX-BTET-BE-?ME?TT?XTTT-TT--T--XB-
-B---?T-T--XM?--E--MBT-?oET?-TBM-XBTTTB-oTX-BX--o|T|TX--B--oTT-X?E-X?ET-T?X-o------Xo-BXME-|MooBTX-|o|oTo-T--o-?-?T----BB|-ToTTXBXX-M-oBTTToT-TX--EoX--MBXXo-B-TEoo?--T--TT-oooX--T---MTo---To-Mo--T?EE-
-X--X|MB-B-To--XX--TTXX-BBTTo?T||T-T-X-B||--o??-T-o--?TTEX-XT-E?-M-MTT?--T-?T-ToMM--X---B------M-BTo-M--M-|T|METT-M-XooX-B|-|EToooo-E-oo--T-BBoBET-MoEBXM--o?-M?BTTM---TTBMEoE--T-o--o?MToX-B?X---oTTTX-
--o--BTB-TMToEoXToTT-T-MT--?Boo?-X-?||?||TM-?|?o?BB-T---E--TTTX|-E---X---|-TMBT||-E-oEM|T---XoT?TTXB-M-B-o-B?--BT-TX?-o?E-o-BXBo-o-oTET--MXTo-oTMTET??-XMo-||B-X-oTXXB?B?o-oB-XBXM-TXT?--TTT?--ET--TBEBv
-?-oX|?-Mo?|?M-E--MTT---X--TXTEEMB-BEXT-?---|B-MoBXX--XoET--X|BXoBXoXXTBXXE|MB-?EX-oTX----XE-TTB--EX?---?B-?TM-o??X-TTT-TB-oTMX--o?|--XXT-T-B-ooM----|oB-?M-T--Eo-Mo-X-XMEE?ooooBB---XoT???-X-E?B-M-X|-f
-T--oEXE-B-TXM--T--T--T-B-B-?X|M-?T-E-E---oXMTT---T-TT-TM-X--TXBX?MTT---?---TooBXBoT-?XT-TT-|?-o-MoTT--Eo--T--oo--M?BoE-|--M?TB--XTTBBTBo-M?XT-TMo-|XM---T-ME-To-TXT----BTEM?-EMoTXBo|E-o-EETTX-B-?X--Tf
---T?|?-o-XTXoB-T----oB-XBT?-oTXM-TTTB-TTT--TTTB-X-X|M-XEB--?o-|Xo?T--oEX-T?-Eo?TXo-X--ooT---TTEo--BEEo-?-TTB--E-XB---T-E|-To?----T-TBB-?E??|-?oo--TB-TB?-T-TTooT-XX-o-BT-B?oXMoT?BB|o?|---TB-TX---XoXMf
-BT--BE?MBTT-|-oo-oXE-o-TEoXT??--M-|oXMoX--ETET?--TT?EEX-XX-|T------???X-MoX--X--M--TX-o-E-o?-X?--M-EEB-EoE-B-ToX-TXXo-XTET-X-EXTo-TMMT-T-o|o|-Xo--XXEBBE-o--M---M-X-ET--TT---?E|-T---oXooB--E-oBBoo?BBf
-BB-E?XoM-B---M--X?--X-o-o--oB-MXMMXo-BEB-B-T-|?X?MXoM-XoT---TB-XBT-oXT-B-BBo?-oT?BX------BB?|-XB-BB?BMo-oX-MoXo-BX-XM----XoM-B--MM?----E|MM--XX--XoB-?o-?B-o-X---B-------?--o---??o?-XX-B?B--B-X-o-X-of
---Eoo-oo?--B-E--BBM?-?-M---BooXB-XBEXBBo-?oo-BoB?-?-B-B-Xo-E-o?oEo-X?-XBXM-XB-X?BXo--BMo-B---?EooXE--M---oB-X-----oB-X|T--?|B-MB-BEoXB-XMB?-oBXM-?XXBMB---BTooXo----?oMBB??XTMX-BE-ooo-o-EXB?MX-oXBB-of
mMM----XXo-B-X-?---oMoXo--X?MB-?MBXET---E-EBBXo--|-?MB|M--?EX-o-Bo-X--?M---o|XXM?XBBE---MX-B-E|XX-B-XBBBX-oM-MB-M|XBX?--B?--Mo-XEMM-o--oMBB--?-o?Bo--XoMXB?-?Mo--o?BX?oX-E-MBoBoBXX-B-?B-E?o-??MMM?XBo|X
X-XXXXX-XXX-XXXXXXXXX-X---XX-XXXXXXXXXXXXXX-XX--XXX-XXXXXXXXXXXXXX-XXX-XXXXXXXX-XXXXXXXXXXXX-XXXXXXXXX-XXXXXX--XXXX-XXXXXXXXXX-X-XXX-XXXXXXXXXXX-XXXXXXXXX---XXX---XXXXXXXXXXXXXX-XXXXXXXXX-XXX-XXXXX-XX
