----B---------------o----------X------------------------------------------------M------------------------M---------------------------------------------oB--?-BX-----------------B---------------Xo-Bo---
--------E---------------X---------?M-----------E-------?------o-----o--------X-----M---?-------------E---B-----B---------------X---------B---?----X----o----------X--X-------EB-------------------------
-----------------------------------------MXo----o----------X---X-----o-XXE----------o?-------------------------E-----------o---o--B---o-----------B---------X-----X--X---?---E-----------E--X-E------M--
--BB---B---------------------M-----------o------o----------------M--X---------B-------------------X----B--------o-B---X----------------------o----o-X----B------------------------------------X---M-----
----------?----?--------BE--------E----------XX-----------o------------X--------o------M------o---------o-------o--------X-----------------X--------X------B---------------o-------X----?---------------
--------------------?---?--------------X---------------------B----------MB?-M---M------X-----------E----X--------------o-X----X---M------?E--o-----XE--?------X------X--X-----?-?---?---------o---?-----
---------X----------------E--------?-M-----------------------------------X----?B-----M----------B---------------------?-----M--------------------------X--------------------?--------------------o-M----
----------EX------------M-----o----B-----------o---MX------------B-----E--E?-----?------o---------------X?--E------------------E---------B------------------?---------Xo-oo--------X----E------XM------v
-----?------?-------E---------M?---X----------oB?--M-------------E---?-----------------------E----------------?----------------B----------MB----------------------XX----o--?----------?------------X---f
-------------X----------E----B-----o-----o----------------------?M---------------------------M----------------------o-B-----------------------------o------X------o-------X-------------?------X-------f
-----M--------------o---E-M----------------?------------------------------------X-------------?------E----------?--------------X----------------------------B-----------X--E-?---------------B--X----M-f
---------------X-----M------------------M-----------X-----o---?-----------B-------------B--B-------?--B-------EX--EM--------B-----E------B-------------?-----X?--------------X--B---X-----------M------f
-------o-?-M--M----------E--------M-E--o-E-----B------B-B-X-----oX---oE----B--?--X----?-BB----o-----B---?--X--X-----E-XX----o-o-BE--------o------X-X--X-------Xo-o--?-X-----o-X--o-?-------o-------M-?-f
-----------T--------E-----XM-M---EX--------?--------?-oB----------------MoE---M-------------M-o---?-o-----T-o-TT--B----------E-----------?E-B--X-------------?----E----TX--T--------?--------------T-T-f
m---------T|--|---E-E------------?---E---o-----TE--XT-Too--M?-M-M----E-----T--------ET---T---o-oE--TE--EX-|-M-|---oT--o-------E--EE------?-o-----EoB-----------B--T----|T-E|-E-To?-M-ET--------B--EET|-X
XXXXXX-XXXXXXXXXXXXXXXXXXXXX-XXXXX-XX--XXXXX-XXXX--XX-XX--XXX-XXXX--XX-XXXXXXXXXXX-XXXXXXX-XXXXXX-XXX-XXXXXXX-X-X-XX-XXX-X--XXXXXXXX--X--XXX-XXX-XXXXX-XX--XXXXX-XXXXXXXXXXXXXXXXX-XXXXXX--XXXXXXXXXXX-X
