------M?--o-M-o---o-o-M----XM----X-------XB-??E----o-oX-B----E----E-----Mo--E------M----?-------M-X--XB--BX--BX-E-XM-B--X--X----------?-o---?-M----B-BX-?-?-??----B--o-------X?B--?---X?B-----E?EM--?---
-----MX-X-B-E---M---M---oX--Bo---M--X--------B--?o---?----EMB-ME---X------E--XBE--------M---------EB--BBBMX---Bo-?---E----Mo---ME-EEoM-B-?----M--MM--MB--?---oo--B--MX--?--B--?-------oXM--o-BB----X--o-
--?----B----E-----o---X-B------MEE----Bo----M-X-o-----?oMXB---EM-B------EE----?--XM-Eo-----XMX-B---X--MM-X-------?--X------o?---?-----Mo?--E-B-X--?--X----BBB--XMEX-B-EB--E-o-B--E?MX-------E-E?-X--M---
-B----X--o------o----o-B-E---oMo-o--?---B--E-??-B--o---E--M-XE-M---E--XM-oX--?----E-Mo--BXXE-B--------o-----?oX--E------?B-?M-------o?-?-?M----------o--B---X--o--E-B----MoB-----Eo-X-?-B?--Eo-E----E---
---X-----M-M-?--BM---EE-?---EBX---o----B-E--?-M-M-X-------X---B---B----X--?X----?----EB?------------B-MB------M--E--XE?BMo---?--?---oM---oM?-------M--?M------------XM-M--M?-Eo??-------B??-X--X--------
-?-oo----X-o-M-o--o---MMBX------?EXM--B-?M----?X---M-Xo----X-?-Xo----M--?-EMo-?B-M---o-?X-----X-------XME-B----o--?-oEM-B--X---X--M-MX-----oBEM-B----XE--EX?-M---M-?-----B-M-X---?-X-EM---XMBM?E----?-M-
---?---XE-?-?XX-----MXME?--B---?E---o---B--oMB-----?-M-o?-M?-B----XM--B--ME--oE--------X-M--BM-E-----X---?--EMEM----B-----XB-BX--o-X-BoB-------------M-Xo?-M---------o-E--E-o-EX-----Xo?-B---M----X-----
-o??o---ooM?-?X--M-------E-X-----?-----MB--o--EMXX---o---o--o--o---B-X-o?------M?----------X---o-----B-o-?BX-------X-B---?---E-------oX--o-E?oX------B--E--B---o---X-B---E-B-M-MMX--X--MoM---o-?EX---E-v
--?o---B-?--o--oM----B--?--M---------M------M---M-??-EBX--BM--E---o-X-B-E-M-M----BB?---EE--EXXM-XE?----BE-o---?BE----B-?-X---?-E?---B-M-X-------EM----?oo?-----?---M---o----B-o---o------------E-----oBf
--o?--BE----MXoB---EM-XE-----?MB-------M-E-----oX---XB----E----M--B-o-X--?oMMo?XX---oBM-o-?----EE---?-E----X-X-X-E-M--E----X-o--B----BX--oB----E-?----Xo-X--?-------?-?X---X------------E-?B-EM-?-X---Mf
----EB----B-EB------M-??-XB-------M-B----M--------M---B-M?---E-X?--M--BE-Xo-----MX----E---o-o--X--?-BM--E?--Xoo?o-??E?E-----EE-B-B-------E----o------?--BB-Eo-o-----E-o-----X----o-------X-o-XX--------f
-----??-o----?o-?o--BX-BB--M--o--X---?MB---M---------B??---BM----?-----B--------------??-?-Mo-----X-?-BEB--oo-M------E----?----E-----??-M-------B-------BE--?E-----o--o-----XB-o--E--M-o--M--M-M-oB--o-f
-------------M---o-----M--MEB--M--?o--M----B----?M--MX------?--M?-o---B--EBo---?--B--o--Mo-----??---X-------BBEoo--?-------X--E-ME---XXM-XM-M?---B--EB-E-ME-X---XB-B-----B-----B--XM------BB--BX-o-----f
---------BBBX--X-M----M--ME-B-?----E-----M--o-E--o------B--M-B----M?o?--BEM--XEM--M---M--E------M---o--------X---B---EE-----M-?----?MX?---M----M--M-?--XX-X---X----oX--Bo---B---M------?----X--ooM---X-f
m------------------------------------------------------------------------------------------------------------------------------------------------------------------------------------------------------X
X-------X----------X---------------X------------X------------X-X---------X---------X---X----XX-----X-X--X-----X--------X----X-------------X-X--X------------------X---X------------------------X-X-----X
