------E----X---M-E-?M--E---E?----oXX----X--E-o-----XB--B---E----BEo--o--E-XX----X---M---?-B--E-B-?--?-o-E--oB---B?-----o--XE??o-----M?--------?-M?---E----------oX------?-B----??M--X-E-X--o-----B--BME-
-E--E--o--o--E-E---?X-M-oXB?--o-E--??--E-?---MB-----oE--X-----M---X--E---MM--B-B-M-M-BE-o--oBB------BE--M--X--X-oE---------B---B?-XM-?--E--MM-?B-----M---X---XE---XX--o-X------?----?--B--?--BME?X---BX-
-X-X---M--??-?E--?X-BX----E----o?-?---------?-ME------ME-X-------X--BEM--??-EXX-B-oB-X-o-?-----E--MM---X-o-------E------?E-?---XEM----E-E---?E-X?-?-B--M-B--M---B--M--oX--EE?B-oE?-B---B--M---BM----o---
---E--E?-?---Xo---X-E--o----?----------M--E-----B---------E---o---B-B-?B------B?XBoo--B------XBB--M--X-o--o--------oX-----?--M-B-----E?X--M--BME-EM-----------B-Mo---E--E---------EBE?X?-M---E---oX-B---
---X-------oo------BE-E?-B-oM?-?M-------M---X--?-----?-----Xo?X--E---M---B---------X?E----X?--B------B------B----?---M-MM--o---M-----X---E---?--?-B--------EX--MB-M?-E----E-------o----X-M-------MEEXXo-
-o?-?-o---o-E-----o----ME--B-B---------B-EX--oo-oBM-o?----oo---MXo----?-?---X--oB-----B-M--E-BM-?-o-----M-----X------X-MoM-----B----oo-----B-X--M---------oEB--XE---M-------o----oM-B??-B--o---------X--
-o---XXXoE--EMoo--B--B??-B--?-?-----o---XEX--o------M---MXo-------?X---M-?-B--------B--X?------o---?o-X----o--X-B-E?--B-E--X-------M------X-XM?--o-X--E---X--Mo-?--o-----E-B-oB-X--------M------B--o-?--
-X--------B----oo--X----XE?-Eo?X-oB-BBX--BXMB--o?----------?-E---E-M-M--?--X---?-E-X---ME---?-----o-X-------B--oE---MBB---?----E-EoE-----o?ooE------o-MB-?--Mo-----E?--o------BM-E?-o--?-E-------M-----v
-oM-X--E-XXB----E-XB---M--?--BEM-?--E-?--?---Bo--ME------BE------MBEE---E?-------E--B?------o--X-X--E------E--B---------B-X--oXM---o----o---E?-?-----B-----------XX-E----ooXX---?-X?-MXBME-X-?------o-Ef
------------Moo--M-----------B?-----o-X-Xo--B--M-EoB--o-M----?B-------B---?---?-E----XMEB-E------X-XB----X-MX-X-----B-------X-BB---?-EB--o---BB?---E----o--X--E------------XE----?--------E-oo?EBo?--?-f
------M-o-M------B-BE-M-XB?X----XE--X-------B-----X-o-o--M-Mo?-XM-o--E-XB?-?-B-B-------X--E?MM-o-oM-XMX-----B------X----XB----Bo---Mo??--M-BX-MXBE----B-E----?-XE-o--?-----XE-----X?-M-X-?---?-oM-M--X-f
----?M---------E---X--X-BB-M----?X--------?XM------o----oo----E-E---------?----XE--B-oXo----M--?-o--BEX-XoooB-----EBo-B-----oE-B-X-----------BB-----o-----------o-M-M-------o---XMo--o-----?-BX?-------f
-oB----M?-E-X--E-BEo---E?----E??--EB----B------------------o-?---------E--X--E--BB---oEMoo-X--EB-B-oo----XMoE------ME--BME--o------?--BEE-XM-B-B-----B--o-?M---Eo-------oE-----E---B---XX--B----XB-----f
-XE--E-----?-MEXo--E-------------E--------?-----XoM-oX----MM---------B-XXB---E---o----EM-M---BXo-o-?--Xo--X?---M-----XM----------X-BM---X--M-M-E-EE--o-B-o-??---------M-?X-??-----X----B-M-B--E--M---MXf
m------------------------------------------------------------------------------------------------------------------------------------------------------------------------------------------------------X
X-----X-XX--X--------X-------X------X--------------X---X-------------------X--------XX--X------X--X-X-X-X----------X-------X------X------X--X--------X-------------------------------------------------X
