-----TME-M??-oX--oo----Eo?--M--MoX?-----E-E-B?-B-?-M--|--EEE---?-?X-?BB|BB-XT-?--M?|---B?--BX----X---B|E-MoM-o-M-B-M-B--MEX-Boo-o--B-oB?-BX---?M?BB-|----BoB----E--?-X-?MT--B-E--T--B-BB--T----MX---X---
-|X--?----Mo--?M-To-B-B----X-----o-X-o--B--B?-BT?--M----?-|---Xo-E--oB-B--oB--?-o-X?-XBXBE---?--oo--o------B-o-T----------X-M--oo-----o--o----o|X----ET--MMX-B-----B---XXX?-XXoEB--M------XB?B-XMX---X--
-?--X-X-B---o--BX-o------M-M----B?B?-BoE--XBo--BEB-------------?---BE--BE---o|-MB-?-BB?-?BT--BM-M-Xo---X-X-?X-?---T?B-XB-EX?M---MX--?BT-?o-----XE-T?-o-BBX-----oo----B--o-XE-?--oEX--BME?X--E-|o?---?---
---o-BX---o--o-T-?--?-?--|oo-BB?X---?XoMEMo?--XXB--oM-?MXBEB-|----------E-MM-----oBT-?XTMEB-?-ME--M--MB--BE?X-XX--X|?--XM---|--To-B---oo-XB-o----X-------ET--ooXo---B----X-o-oM-B--------BX?-Bo-E--T----
--X--X|o-Eoo-E-----X--M-?--TMo-X--??XBMo--o?-o-EMB-EX-?--o--M----M-M---?-?B-|----?----E--B------XB-?--?--X--B--Mo-oB?BM-o-?--XM--oo-oo------E--?-B---XoX-?----------BE--oX---M-?T-B--oX---Mo?-T-------X-
--EE-X----E------B-|-X-M----?-o-o-Bo----M--X-?E-oXE--oM------B-XB-X-B---------MM-o?o--T--M-------o?--M-------B-E-oX---ET-|-E---BB-E-X------BB-B-MB-|---?E-----XX|M--X?Eo?Xo--MB-oX--B?X------------XXXB-
--EXEXM?XM-B---M?-|-B-XXB---MB-?-BX-T---B----X---XXBE-M?--X-Xo-B----BM-XBMX-oX?B|-|T--|X-E---X|EE--MB-TX-MBX?-o-Bo-M?M------X-XXX--BX-Eo-XE-BXo?---EBE---X-oB------------o-oB---X?o--XE-X-oBB--M---B----
---oM-?--o-B--E-X-T-?-------MM-Eo--?---|||----o--?--|-o--XM--B-oT---B-B?-XT-M---T-B?E----|BE-oTM|EEXX------?o-E|MB-EBoM-BoMM-?-----X-B-M-E--BoXXBB-oo?---XM|-------o--Eo--X-Xoo--X?-o-B--E-X------M?-X-v
-|--ooMoB--XEB-T???-XoXM|o-T|-BM---E--BoB---M-oBX--oX-X--?------o?-o-o--BEB|o-XMM----B-X----B---TMB-oBo---B---oT-?-?-EEMB-M-B---------------?oME--oXX-TE----XB----X---?--XE----?MEM--o|X?-X-X-MM-M-M-|Ef
----M?-o---o----?----X--B-B--B-M-M--MX-o-To----M---?-Moo?-|M|-X-M-BEE--MXT--?o-X-?|--??---Bo-E-T|BM-Mo-?M?-Xo----X?B--X?-X--?EBM-EB|-|----o-o--EXo---Xo-?---T--To--o--------|-------XXM?-B--M-|-TXB-oo-f
-oB|---TXooXBEBB---?|o-M-EEB-?|-To----o--B-?-T-----Xo---BXMo|X--?oT-----o???oBXTE---?|?|-?Xo--|X-M?---|o--MB-?XoE|--MX----o-B-?-?-Mo-X-M---------------X--MB---?---oX|---B-----X-o?--X-BB|Xo-X--------Bf
---M?X----B|--X----?--X-MB-BXE----X--?---B-o---M--BX---XT-MM?----B----BB-MB|o---TBE|?X--M?X-BB--?---E-Bo---M-X---MMX---E---|-X-|B--o---|B--E----|---B-o-?MM-?-E----|B|-E--------XM-M---M--?-XT-----B-X-f
-o-|T-oo---?BXX-M---?--B-BoE-?--B---?MB--B?B-M--B-|---X--M-BT-?-------E-XBXM--XB-??T-oE----MXo--MoBX------EBB-EX?TM-?BTM--------X-o------M-----B?XXM-XM?-XXE-BXX---X-M-BM|-?---oM?--XX----o--X--?-M-E--f
--MBBB------o----E-B------M---?----B--------?-----E---?-----?BX---o----|TM?o-------BoMX---TEMo-o-o--ME|T--TX-T-M-?---To--X-?EXXX-----B----|M-B-X-M----X-M----X-?-o-oo-XBX-E-?--o--M-?-E-XXoX--o-ETB---of
mBT-o-?-?---XX|--o----X---B?X??-X--oo-M-o-T?---?---oTB--MB---E--B-o-MXT-o-E?--??-T--o-o----XM-o-|-|XoXooBo-?-B-XoXB---|------BE?--?oX-XX----MoX?--|----?B---oo-X--E---M---|o-EX-B-oB-?B--ET------XB--?-X
XXXXXXXXXXXXXXX-XXXX-XXXXXXXXXXX-XXXXXXX-XXXXXXXXXXXXXXXXXXXXXXXXX-XXX-XXXXXXXXX-XXXXXXXXXXXXXXXXXXXXXXXXXXXXXXXXXXXXXXXXX-X-XXXXXX---XXXXXXXXXXXXXXXXXXXXXXX-X-X-XXX-XXXXXXXXXXXXXXXXXXXXXXXXXXXXXXX-XX
