-X------------B------------o----------oM----------------------o-----?-----------------X---------E----X--------M-----o----------------------------X-------------------B---------------o------------------
--------------E-o----o-o--------o-----------?---X-------?-X------------?-------------?----------------------X------------------o------------o-------------------------X----o---oEo--------------M-------
----X--------?X-------------------------E-------------E----B------E----------X----Eo---M-------------o-M-----------B-?-------------M?----------------------------XX-----Xo------X-------E----------E----
---?-M-?-----E---------B----o----o------------M---Bo------------------B------------?-E-o-------------------------------------X--------E----------M-X---E-------------------o-|o------o-?--?-------o-----
-----X----------------------------------M-------E--o-|-M-----?--------?-|-E-------B---------B--------B--------oo--------------------------------oX-----X----M----?-o---------|--?----?--------B--?--M---
-----------oXT---X----?------------X---M-------B---o?|---------------o--|---------o---------X------X-------------o-----E------o---?------------XM-------------XXM-----o------|------------?-o---------M-
-BX-X------|--------?------------X---B--------E-M-E----M-----------?-M--X------?-B?--M---X-------X-----o-?-----------B------------?-------------------?----------------------|--B-----------B-----------
------?-M--|-------?--------------------------------B----------------------X--X-----------------------------------o-M--o----E--------B---B-X-----------------o-B----M--B-----|-M--o-----B--------------v
---------o-|---------o-----------------------B-----------X------------X-MX----B---------oB----------------E--B-Xo----?-------------------------------------------------X---BE----o-----MB---------X----f
--X--X?----|-----X---B------o----------------X---X-----------o-------oo---|--?--Xo-B-o-X---o---BB?-----B---------E----------o--------------X--X--o-B-----------------M------?--o---------?------|-o-B--f
--B---X-|--|-o----------B-M-----MB?---------X-----------X-----------------|-------o-----o--E---------X---o---o-------?---------------------------o---------X----BM-E---B--B-------------?---E---|------f
-o------|--|--------?---X--B-X-----X----------------o------------X--------|---E---X----o--B---Xo----------------E--------M--------oBo--M--------B---M--------------XX-----------------?---?--X--||-----f
-------||-||--o--------X-B--oBT-T?-M--|XX?--T-B?--?-?T--XX----B-o-o-M--o--|--|-|o---T-|---M--X|---B-oo-E-B--o---B--------TX---oT-----M---TT----?X---ooT------T-o?X---MTT---o--o---B---------BM--|-XET?-f
----------|||T-------B--------|X|--T--|T----|----X------|XB-E||----X-BX---|---o|X--B|-|---T---|--T-T-?-E-o---|--|-|------|----||-o|---T--||T-------o-o|XT----|-X?--T---|-o---ET-------B----|-E--|--|B-Ef
m---|----E||||--?X?-T--T?|--|X|T|-TB?||-----|--E---X----||---|------M-----|----|--E?|?|E?-|---|----E---o-----|--|-?------|--ET|---|-|-|-o-||----|TB---|-|-X-o|---?-|---|T-T?-M|-o---|-?|---|----|--|-T-X
XXXXXXXXXXXXXXXXXX-X-X-XXXXXXXXXXXXXXXXXXXXX-XX-XX-XXXXXXX-XX-XXXXXXXXXXXXXX-XXX-XXX-XXXXXXXXXXX--X--XXXXXXXXXXXXXXXXXXXXXXXXXX-XXXX-XXXXX-X-XXX-X---X-XXXXX-XX-XX---XX-X--XXXX-XXX-X-XXXXXXXXXX-X-XXXXX
