-------E----------X---B---------B-------------------------------------M-X-------B----o----X--B-----------X--------------o------o----X--------------------------------------------------?-------X--------
------o--o--X------------------X---E-o--o----o--------E--M--X-----M--?--------o---?-------X-----------------------o----X-------X----o---?------------------o-o--Xo-----------------------------------M--
-oo-----o--E--------------------------B-X-------------B-------o--------------?----o----------------------------Bo-B-------------------------B----------------?---XM----------X-o----------B------??-----
----M-------X----X--------B--------X---o------------------------o--------B--?------B--------M--------B------------?--o----------------------X--?-----?-----------MXoE-------------?---------------------
---B-----B----------?-o----EB-------X----o--B--------X----o---------MoX----------X----------oX--o---?----------------B---------X-------------B-----oB------X-----------------o----------?---M-----o-----
---oM-------X-----?X-----o------o-M-----------Eo-E?---?-------------------o---------------------B-X------------------o------------M---X-----------X-------------------------o--o------------------?B----
---M-B----------------------------------------EM------------B-------E----------o?----X-------------Eo-o--------X----------------------------?------B-X-----------o-------oX------?-B--------------------
----------------o-B--------X------?-B---XB---M--------M--------o--E-B-B---------X------M----------------B------M-----------?----------------B-------------------?-M-X-E---------------------------?----v
--M---X--------o---------o-E----M-E-------M--------------XXXX-------X----------E-----X--?-----E----------------B---E---B---------------------------?------------B-o------B-----E--X-----M-----------X--f
---M-------M?----------E----------o------------X----X------X--B----------o--------oE----------------------------X----o-----------?--o----X----------------------?------?----X--o-X----------------?--X-f
-------------------Bo----B---M-----ME---o------------------------------------B----X----------------------------------------------------?------------------------------EB------------o-o------------oo--f
-o---M?------B-M----------E-?--B-E------E---------------------------------o-------M-------------M--------------M--------------------X--------------o-----------------------------o--------------------Ef
----------?o-X------------?M--------X--o-----EEX----o?------Bo-------o?-X--------E---o--?----o----oo-----------X---M-o?-X----------??-------E---X----MB-----------M-E-------B---------X---Mo--Mo----Eo-f
-----------T-----?----------B--M----T--oEo---T--E----------o------B--B--E------M-----B-E--------oB---E------------------E----------X-------X-T-X----XT-----o-E--------------B------B--B--------B----X--f
m------E--?|--------M--o--?--|------|---T---TB------E-o-----------T------------------B----------T---T---------B-o-|------------T--XT-----E-|E|------EoT---------|-------o------?-T-------------o-X--T--X
X-XXXXXXXXXXXXXXXXXXX-XX-XXXXX-XXXXXXXXXXXX-XXXXXXX-XXX-XXXXXXXXX-X---X-XXXXXXXXXXX--X-XX-XXX-X-XXXXXXX-XXX---XXXXXX-XXX--XXX-XXXXXXX-XXXX-XXX--X-XXXXX-X--XXXX-XXXXX-XXX-XXXXXXXXXXXXXXX-XXX-XX-XX-XXXX
