-------?------?----------------o---X----------Xo-------X-----------?-----MB---T--?----X-------T-----M|--------|-----------------EX--?-------?--o------------?----B--|----B-|M---B---?-----X---------B---
-------M--B----------------B--?---?-------?------M-----M-------?T-----?----------o--------------X-M----T----------------M-E--T-------X---E----------------------?-------------M-o-----|-----------TM----
------------|--------T----------BTX------M?-------------M----------------B-E--BTX-------X---o-|-TM--B-------M------B--X---------o------------?----------o---?--E----?E--|------o-----M-------?----------
-T-----X----------?--------------T|?|-B---T-----o------B----------?-----------------------------?-o------E---X-?X-------------------M---M--M---------E----?--Mo-----?-----------o---M?X--|BB------------
-----XE--X------------------|----E------T---?------B----------o------------ooo----X-----------o---B-----------Bo-----?------------------X--o---o------------X--E-----oX----X--T------BM--B---E----------
---B---B--------B-M----E-------M-o----?--------E----X----X---------o-----------o--X-M-----X--------|-----T----X-----?B-TX----?-----B-------M------XX-X---?--E--X--------|E---B---X??-o------------------
--------------------BBB------?--------E-X-------o------------------?---EBMo--B------X-----o---B-MX---oB-?--M----|------------------X------------B-B|------X-M----M-----X--------oM---------B--------M---
---?-----------B--------------------------?---------------?o--------M----B---X----------B------------M-----------M------o---------E-E-------T--------?E------X----?-BT------|----o|------EX-----T--T---v
--?---------Bo-----Mo---B-B--|---M----T-B---?----------M----X----B-----B-X--o-------X----T--------?M-----------o-X-X--o--B-----B---E|--?--------X-----------B?-BB--M----------B-------|----------------f
------M--------------B----?-M---M-----MM----M-----X---------oX----o--------T---------------------------M---oE---EB-----------------M------------------o-------------?o------------B----------X---------f
----?------M-o------E-X-------------B-B---E-----------B------------E----M------------------M---E---|B-----------X---------------B----------------------X-------------M-M------------BX--M---BEB--------f
-------M--o-----------M|-B---M-E-----------?|---XMM---------------X-M--B--?B----X------B--XB-oX----------T------M-------B-B-------o-B-----------T-------B--------------X-B-X-X-o-------o---?--X-----|--f
------E-?--?-----M----E-X|o-------X-?-----M---------o-BE--------?-X---??---B--?B---X--?-----?X-----?---MMX--X-?-----E---------X-------X-------X-B-B------TX?--T-----o--------B?----o-------------------f
-----?-----|--o----------BE----------X-------------------E-----B-?---------------M----B------------?-----------------M----M--------o---------M------------X---------------B-B----X---T--M----------B---f
m-o--------------------o---|-|E-----B---------X|----------?-----M-----------------------X-------------?---------------EBM---------o---------?----------------?---------o---o-?--?--X----B------X-------X
XXXXXXXXXXXXXX-X-XXXXXXXXXXXXXX--XXXX-XXXXXX-X-XXXXXX-XXXXXXXXXXXXXXXXXXXX-XXXXX-XXXXXX-XXXXXXXXXXXXXXXXXXXXXXXX-XXXXXXXX-XXXXXXXX-XXXXXXXXXX-X-XXXXXXXX-XXXXXXXXXXXXXXXXXXXXXXXXXX----XXXX-X-XX----XX-X
