-oBo--Mo|--oo--|?|?o?X---?--XoB--BXo-o??BX---E--T--o--EM?M--oX-EoE?--??-??-BEo-o--XBE---?-B--E--?-o-XBXEBX---o-??Xoo-Xo-o-T|?---o-?-M??o----XX-|X-|o??Bo-B-BooXX|o---BX-TX-o-X----XXMoX--E-|--E?o-X-----
-??-?-BoMoX-X?---M??EBEMB-oX--o-X-X??--XTo--E-XEooXB?-XT---?-?oo--X-?oX-??--XEX-B-?-EB-X?-|-?EXB?XB??|XXE-o?ToX-B?X-M---E?---Xo|-XXE-E-MXoBBoo-BB--Xoo?o--oE--?-Bo-Xo--XMoXoX-?-X-XX--?E-o--X-o-XM-MBX--
-oBXo?M-T?--BMoE--X-X?-?----XBM--o-BEB-??B--X?-E-----BX-M--oE---oXXE|----ooB?XBBT---E-E-E--BBMMX-Xo-B-oB?-M-?--X|X?XMEXT?XXo-E-?EB-X-EBTXB|--?-BX-MXo?-X-o?--X---X?oo?-?XE----?-oXBX-?B??X?EoX-EoX|-?T--
-E?EXX-XE|B---TXMEo--E-?o-M-Bo-?M-oX-??BoB?oXXXX-------BXoM--MMX-XB??M--oo|-XB-E--EX---X?X-o-?X--?X?BoM?-?--M?Eo---o?Bo-o-?-X-X-o-MMMX-B-X--XB-XXX---BX-MM-o-oBEEXMB-o-XXM?MEEB--EBBXo---?Mo?B---?-?----
-XXoB?-oXMT|--EBoX-MBB--oX---oEET?o-ooX-o-BXM??-o---To-E--Bo-oX-M-M--|-?----?|-E|X--EEo---B---o--MXTX?EMTXB-?X-MX-X?-oBXEX--B-EEoXEEMX-?oTo-X|--EoEMB-X--o---X?oX?BE-B-oB|-E-|-o-?--B-o??---?-?-o---X---
----B--M-o-oE-o--X|X?X--X-E?EBE-E--o??|-BE--XXX??o?-B?-MoBE-X?--MXM--E?X-?BEoo?Xo?X-X-|-?X?oXXXX-?-o--M-Eo-B|?--M-?-?X-?----?-EB?o-ooo--?Eo?-XM?XX-?--------XE-|---X?BXoXB-o-Bo--B?-X?EX?-?E?BX-?-X---o-
--oXMXTBBX-BEX----M----o-XBo-T-??BX?-|M-oo--XMB-----?XMB|-----M--X-BoXX-o-oX--EXo-?X-B--o|?M-BT-|-B-?o?--?-o-?---X--M--M-E?-To-?-o-BM-X-XBMXTEMoB-B-o-X-?||-X-MM---?BB-MXo-?-oBTMBo-XT--MB?-?o-EEX-o----
--ME--?oBB-X---X--X-??--X?---Mo-?M?BXoXXXo-oBX-oX-T|--X--Xo--BX----?--B?-?M-----oT-???T-------o?TE-X-?--XB-BX-|X?MT-XEooBE--X?o--To-XEX---?-??X-oXM-M--XB---?BMoo--X--B----oX--X--|?--XB--T-oo--o?--E?Xv
-X--B-E-B----B--BME?EB--B-?-MX-M-XXXEBXXoMX-X--|----ME?X-?oM--E------ooXXBMo---M-?BX--BX----oT-BX??-TT---|--To--?Mo-EM---E-X-E?E-oT?BB-BB-oX?|BoT--XE-?oB-Mo-MX-TBBo-MMMX?--?|BT??MXM--BMo-E-oo--M----|f
-MX?-XX-?oXo-M??-oX-E?TMMEX-o-----X?-B---Xo--X--?B?M-oooE?B-?---M-oo--EX?-BX-|---?X|XMX--X--?-E-------B|BMB-B?--MXXM-XoME---X-B-?XXX----Xo?o--BM?B-X--X--??o?----BMo-B-MM-o-X--MM-E?oXoTX-o-XE-?-EEo?--f
-oX-EoX?-MX---?-XXE--X-?T-----?M--B--oEMX--E-Bo?-XX-??-o---?oBo--BMX??oXX-X-oEM-?BX-M---XE?-XM?-??MooM-?--oX-X---?oXX??TB?ooEX-XM-oX-TM-B-????-o?oBMX-|o-Xo---oB-TX-EE?MEo-oE?Xo?-B----E-X--?-Xo-M--?--f
--X?-E-XX-?oBXXX-oE--oX--X-X-Mo--o-XT-M-?X?-oB-E--X|-X-ooTXX-M-E-X?oM-MEB-E-EM-BX-ooB-E-M-oM-BX---?-BB-oE-?B-oBXMX-X--BXo--?XX--B?---XM---?|X-X-XEE-X-X-EX-?-o?XBXB?E?-XM-?B-MXo-EEXM---EM-M-?o-oXXEo?of
--XEMoTX--B-oo?oo---BX-X-?---EBB--M-?-?XX-?TBE?---X---E--?oooT--X--?TBE--X-BBXB-oMBBoo---XXX-BXM-----B-E-E-B-XBM---E-XMM-BXBo----o?M?B-X--?BMME--XBo??B-BXE-?X|-X?---EB---|BB?MBM?-?B-X?-BB-XEMX-?-XM?Bf
--XX-o|BoBBX-MBXXEEBoBBX-B--M---XM--M--oB-X-X-B-XEooM----X-EBEXBB?o--XX?-B?-B-o?Xo-?B-o-X?o-ooBoBTo--BXM--MX--?-E-B--?X-B-oo-XEEB-|Mo-M-EX-B--XMoo-|B----oX-?B?BEoXoE--oE--?X-oXBBBXBM?-XBB?-M-X-B-?o--f
mXo--MoX|---o-|?--EBX?B--XXXBMBBMo-?----o-BX|EXX-oo??o-?-M--XBB?-oo--E-EBXo--XB?---XBBX-Bo-MEMBT?MMBB-?Bo-oB?Bo?--XE---oM-X--XoB-XM-?XE?EBXB-M?T??X---B-X-?B--XXE--X-BX----?BEo--M-oBB?oBoBE----XXBM-BXX
X-XXXXXX--X-XXXXXXXXX-XXXXXXXXXXX--XXXXXXXXX-XXXXXX-X-XXXXXX-XXX-XXXXX-XXXXXX-XXXXXX-X-XXX-XXXXXXXXXXXX-XXXX-XX-XXXXXXX-XXXXXXXXXXXXXXXXXXXX-XXXXXXXX-X-XX-XXXX--XXXXXX-X-XXXXXXXXX-X--XXXXX-XXXXXXXXX-X
