-o--EE----------o---B---EB-oE-M?E--oo--B-?---o-E--MoEE---B?-----o-E---E-E---X-X-M-M-----o-EB-----o----B-B--E--X-------Xo-------------------EEE---M--E--?-B---------?---o-X--o-E-BXE-----X--B-----E-?----
---oMM---E-E-X------XE----?-BM-----B----M-B---E---MB-X-B-----X--XoEE------?E--o-Bo-EM----?---B---MX------E--??-o-E---M--o-o--o-XE-----X-B-oE--ooo---oEM-------?-XX-----------X-ME-?--B--M-----o-----B---
------M------o-----M-oo--?o-??-----BEX--?--o-X--EX--?MooBB------?--EM-MM---?-o---M?-M----M-E-XBo-?-----???---B--o---------Eo-X?---B---B---?---o---E-X--MMBX-E---BB-ME-E?----X-?X--MoBM?o---M-X---MXo----
----EM--X-EB-?-------EEE---------X-B?----X-?-M--Eo-?-----X---ME----M-----BM-o--o-----BE------BE---?X----E?---M-o----X-------B---?---------oMB--E---BB-B-Xo-o------o-E----------------E---MXX?E-MX---X-o-
-?----------B------Bo------------M--X---M-?---B---X---?-------o-----BoE---?---EoX---BMM-o------E--o-M--EBB-----E-o----?---?---M-?M-oM--oo-?o?B-o-----?---B--------E--M-------M--?-?---o--?o------M-B--B-
-?--MM---Eo---X-M-B--M-XM---M----E?M-XX-E-------o-E-MM------B--?MBB-E-?-X--?-------BB-o??MEB-?--o------o--B---E-BE-B--------X--B---B-------------EE-?Xo---?-----------------EX-------X--o-M-oE--?E----?-
-X------Bo--?------ooo--B---Xo-M-o--o-E-X-oE?E--B-X-o---B---M---?----?BX?-?-?--X-o-M-X--Bo--B-EEXX-E?---?-----E--oE-?-?B---------o?-------B--?----oB-oM----o--------?-E-X---oo--B---oE-----MX-B-M---M-?-
-B--o--?-?----------?-----------XE--o?o--?-------E-oM?-?--X--o-o-B-?--M--?-M?E------Xo-EM-M--X--B-MB-----?----??B-------M----------?--------E---M----B-M-B-MM-------------o--------B------------------?v
-E----?-MB-?-X-M--E-oE-E--E-MXo-----?-Eo-?---o--?--E--------E-B--o-----oBBXB--MB-?E--M------E?-o??X---M---ooBM-X-oMX---X-------o-B-?-----oB----M-M-X-XB--?XB---?-E---X--?-oo--?M--X----o-----XX?---E-E-f
-EEB--------E-?E--?B------BM-----------XB-XoE--EBB---EM----?--Bo---BE?E-XXX?---E-EM--o?--M-E---oB----E-MM------E-X-B-o-o-B------o----o------EM-o---B-B?---B---MXB---M-EXX--XE----?-MMBBM------?--?-o---f
-o?-B--?MBM------EM--------M---MBX---EM?o---M--o-----XB?--E-----Mo---E-?----E-X-B--o----M---------E-X-X--M-oM-----?-XEEBBB--------?--?oB--?--Mo-B---------M----BoB-MBM-------EB-EM--M---?-B-----M--?-?Xf
-BE---------Xo----XE----XB---?-------X-XX---M?-??--BMM-MM??-?EM--?--M-EB-M--?--oM--o-EB-BBoB--M-oEM-----M-Bo-X-B-ME--XoE-B-EB?EEo--EB---------B-X-B----MX--?---EM---E-oB----X-?-X-B--B--?M-M?B-??Bo-XM-f
--------------X------o?oM---B-----E-----Xo?-MB-------o--M-----?-M-----X----M--E-X----------o-Eo-BM----o---X-BE---X-------?-X---B----o---X--?-X--M--oB-EMo---?-?B--E-B--?-E?-oX------B-o-BM---E-M-------f
--E-o-----B---MME--E------oX?-X------?E-oEo------?--B-X-E-B------E--M--??-X?--XB-E----M-o--E-X--M--X--oB--?-----?---X--EMX-B--------?XE?E----XXB-----M-----B---?----B-?----X--XB-------E--M----X-B?--EEf
m------------------------------------------------------------------------------------------------------------------------------------------------------------------------------------------------------X
X-X---X----------------X---------------------------XX-----------X------------------X---XX-------X-----X-----------------------------------X--X----------------X------------------------X-----------X---X
