--BEX---|B-T|B-MBBoBT-o?BoTToM-?|--BTT-ME-o-X-X?X?o-oTo?B-T-TXET-B?--XX-o---X-?-oM|--Bo-XTXMo-?o--XT--B--o--E-T---BXMT-TTo|BTE--o-X-T?XXT?M--BTTEoTMM|T|o-T?-oXXMMTB--|-X---M|---X?oEBMBo|-M--BMTXXTBoE-
-Xoo-XMT|-X-?oEX--M?XEoToTTT---TB-B----X-o-?---o-?XEToT-TE-E-TT-TXX-X|-X?oTo-o-o-X-?--M--XT?T?-TB-?XTBoEXB---MT-X|T-o--T--X---XT?-M-BXT|-|-o-|?-?B-M---TB-XoE-TX--T-X?XT?E-T---M--oE-XoX-?-o-BBT-T---MT-
-----ToBMX-?-?TX-oTB-oooMEE-XB-X-ooToX?oBT-|----X-M-XTT---XX-T---B-T|-oEETXXoXMTMoTE?Xo-X---o-EMXX-X-XXMXo-----oo?X-XTo-ooTX?X-oX-TM-T--?T--?ooX?--T?B-o-To||ooXoT-o--TEE?----X-T-?X?-o-oMTXXoXToE-TM-T-
---X?E-XE----T?---TMXTE--XXTTT--T-B|--?o--To-E-BToX?BT-EEXXMX??---B--T?---o-??MTXTT---?-oo-M?EXTXBXo-E-TBX---?E--|-|X?X|BXo--o?-TX-?ET-oTX-XETTXEX?T||T--XT-----o-B-X-ToXT--TX-B-?MToT---?BoE---XoX-----
----Mo---MT-Bo?E?XXB--M-ToXT-oX-T?---T-?TT--MTT?-XXX-B?oEoT-?T-|X---T--XE--M-X?oTMo---ooM-EBo--MT-o--T?T?--|BBM-|oT---XMXo-Xo-T-?XTo---Xo-E-MT?--XX---XTTT-X-T-XXBEM|T-X---T?BT-T-T-XT--XT-TET-MT-?---X-
-T|-MMM-ooMXE--T--EB-TMo--T-To?M--TXoEXTXTXT--?XE-|ET--TB?---o|-?MMo-?TE--T-E-BB-o-?B--T-BT-o?-o---o|-X-|-BX-T-T|?-?|ETB-o-T-T-M|TBMMo-EX-XT------oTTT---E-M-TM--X??-o?XMXT--oBT--XMo---B?T-T-EMooo--TB-
---TXTBoE?-TT--TE-T-XTM-XB-oM-TT?-oT--T-B-?ToT-X-|-?-BM----XBTTTo-T?T-ETBET-MTXXoE-T-o|TX--T--X-X-EEoBTETT-T--T-T-?ooXM-o-------TB-EEXXXoTE--BTT?-oBTT-o??ET-X?-T-T--|oToE---ToTBET-ET----MT-o-?T|--BMo-
-B-T--T-o-o-----|XTMoB-M|-TX--X-|oo-E-T|T-o?oB-BT--oT-MB-B-TMoToX-XEB---|XTBX----XoMBX?X-oXT-ToETT-T-E---TEB--?B----oBTMM|?T-B|M-XTMEE-oTT-To--oBEX-T--MTE|XX?--T---To-BB-B-E-Eo----E-TBT-X-o?B---MoMXMv
--BoT--E-----T-X--Mo-o?E||TX-E-XE|X-XEoTB-MX-|?T?-----ooXEX|TBX--XTT---BTX--Xo|-T-X-?----EE-T-MXBMXB--?To----B-|-oTT-oMoB|--TT---ET----?--T|oBT-?-XXBXXTBBXEM|E|o|-o|-E--o-|BoT-o|TE-BTE--T-oTXoTMT-oTXf
-MBETTEEM-TXXoBoXTB--?-T?o-M?ooE-ToT-BoT-T--T?To|?-B-BX-TT-EXTXE-M-X--M-o-To?--|TT-TTTEXoBoo--oBT-TB-?TTTET?T?X-T-TB-|TT--TMBX?|-TEBM-EXT-T-MT---MXT--TT--?TB?BX-Eo-o---oT-?-METE----X-B---M-T----?T-||f
-B-X?oo-T-X-TX-o--MMTBXToM?M--o-----BXB-E--BBo--BTT--XoTTT|X-TTTT-T-T|EoT-BTX---Moo-???X---TB-o--oE?-To--TB|--MT---?--Xo--XoB-XB-oE-TB-MToTXM-|-o-EM----T--?--T-XX-o-MT-?-TE-XM--Bo-B----o-ToTXE-BB--TBf
-o--TE--TXoTMTTETBToE---oTBoBXo-?MTBT---ToB-M?MT--o?--o?-?E-T?o?T-?-T-|-XT-TB-?o|BX-BTX?----To-XE-Eo-ToT-o-T--oX-----MMMMoMM-?o-X|---TM|---To?---Eo-XXE----o----o|MXoBBo-T-XTToEB---XE-?T-TX|XMTX-E?BT-f
-BMBo?BEXE-XB-T?X--T-MM-MXX?E?XE-E?XBB?BBE?-o-oBX|Bo?--?-o-Bo-E-Mo-XBM-XE?B---BX?-o-ME---Bo-B?EEXE??--EXoo??-BTE--MXX--M?-?Bo-BBo--oB?|oMB?oX-?-ooB---B?-o----ToX-ME??XoXXBX?XEBTBXX--oXXoB--?--T???E--f
-MTB-----X-?B---oo-oooo-B--MooXB--BMoBB??-XB?B-MXB?XXXBX-XBMM?-MT--B-BEX---oM?-X---oB-B??---oB?-o?T-XBMB---BXB|?oE?EX?BT-BBBM-Xo-B--MB--X?o---E---B--B--BBB?-XB----M--X-Xo-o--BMTo-M---XXBBo-?--?-oMBMXf
mooMMBB---?T?BEXXB-B--BX?--TB-?-M--BXM-EXoB-|oXXM-BMBMoB-B-oBB-X-E-B--B-Xo-B-oB-B--BB-o-EXTX?BBE-|X?ooB--oX?T?XoXXM-?XEoX?-BXBX---o---?MBXX--X-E-XBoMX-oX?oB?B-oEM?T--XB---B--?MX-?-M?-??BBMX-BB--oB-EBX
XXXXXXXXXXXXXX-X-XX-XXXXX-X-XX-XXXX-XXXXXXX-XXXXXXXXXXX-XXXXXXXXXXXXXXXX-X-XX-XXXXXXX-XXXXXX-XXXXXXXX--XXXXXXXXXXX-X--X-XXXXXXXXX--XXXXXXXX-XXXXXXXX---XX-XXXX--XXX-X-XX--XXXXXX--XXX-XXX-XX-X--XX-XXXXX
