------E?----TM-B--E|oEX-o--X?E-----|E------------X-|--------EX-MM-E---MoB-----B?T--T---TX-M--E-?X-----oM--||-T--X?--o----------o?-XB--Bo----?-----oE--TT----BX--B--?M--T-?----------------X---E------TB-
--EBMX-X--B-|----?-T---B-------E--B-B---X--B-|-EoBM--EE--X|E|----M-T--XX||-----M-T---X?-?-T?------|------|-B---B--TB--o-----E-M-M?-E-?--B--Bo-MX----|-?X-------o?|BM------X-T-B-T-XT-X-X-------T-o?---E-
----BMBX--|?-M-|oo--EX---BB--ooB---E-B----M---E--X-|-?---oo------|oE-o?-B---B-----B|----T-?MX-X-Bo-B-oT-oT-----?--E-E---?--|-E----o--X--B--M--?-?T--M--M--?---EM--M----B--T--E|E---M---B--E|---o-X-o-XT-
-E--E------------EX---M----E--M-----------------B-B----|-ME----T----X----|------T-EE-T-X------?-----T--M--E-E--T-o--BBX---M-X---M-B--B|X-o-------TX--BMB---M----TX--T------B-M-?-|-T-?------BM----M-----
-o--oB---M|T|T---T-Eo-------E-|MB---?|----X?E-M-?---?--E---|o--|--EX----E--T---o-|?-?-B-o---Xo|B|-X-T--?-Mo?----T---?--E-XoB----|--M-E-oT------M-TT-----M------|M-----?-X--o-------o---M---B-T----E---X-
-----E-----B??----Bo--E?ooX---?----M-T------B-|-|--oE-----E-|Xo-|------B---o-?--XT|--B?--BM-------TTEM--?-|----Xo---?----T?-ET-|----EoX---|XBT?-B---MM--B--|--Bo--oXXB-------?B--E-E-?B-E?---B-T---o-T--
-M-T---o-----|-----o-o?E-?------M----------|-EB------|BM-|EM---------M-E-X-X-----------?-M---o----?-|-----X------E-----M------XM----|-----M-----||----?-?----M--X--B----X---------?---|-?-------o--|----
--------??-?-X---E---BEX-M---X-B-T-T-----------|?-------Xo-X--o--B-T-----|--M-----------MT-?-------M?|----X-|-----|B-T---?EE------?oT--M-E-----|?----B|-T--B--B--T-BB---E?|T----BT-T--EE-E------E----XMv
-B-M-oE--XT-|--|-E--X--X?-?ME-T--TX--------XB----T-X|------||E-?--E--|-B-o-------M-E--M--||---M---E--Xo-T----T---M--M------T--------M----|-----M?----B------XE-EMoB-------E-?|--B---?M-----M--B-X-o----f
----M--X-|-o------M-------B-----B--|-|-E--TE|MT---BBX--o--|-B--X--o------EEM-?B-oE-o|-E-M-E-------T-T----?X-----oo-E-?-o--?-E-E--M?---?----X----ME|-|---?B-T---B---?B-MB---o-----|--------M--M---TT-M--f
-ET----T-o-----|-?-o---X---|o--MM-------M-MXX-----XBTo-o--B------XT------T-o-E---------oE-----T---E---EEM------MTE----?-----X--o-E----B-T--------?--X--o---?B-M-------|----M?E---o|---X--------|o-M?--Bf
---E-------M-T|---BB?-M---|--M--Bo-X--??----------E---X--|T-o-|--------MT---B?----B--E---EXT-o?B-M|---?-?|--?--|-o|T-o-o?---o-|BB-|-X--M-T--M-|E--?--o|----|-T---?E-----|---??--XE-B----oo|---|B|--E---f
-X-XB-E-|--------X--------X--?-----M-?-?-----------|T---X-?---EM--E?---E-T-E|--BT--MT---E--X?--E?--BX-X---------------oXT------|--------E|-M--|------B----B------?-----X--?-E-?------T---X-M--E-B--o---f
--------TE--MX-|--o-X-|-Bo----?---T-o-|---B-------oT-E--M-E--|------MXoB--E---o-E-------|o--T----?---?-----o-E---------E----E-------BMTM-E--EX--M??-o--?-B---B-------?Eo-------B--EoBE?o--X-EE--EBB----f
m---------o-X-XB?M--T--EE|?------B----T---------TB-?T-E---B-----|--o------M----TT|----|-o-X|T-|-----oT-XMM-?E-|--E--M-T--|--o--B-X--X---o-B---?BTM-M-|--T---X|E-------o-T?-T------T-?----T-E--B---E?--BX
X-----X-------X----X--X-X--X--------X-X--------X----X-X----------------------X-----------X--X--------------------X------X--------X------X-X------------X-X-----X-------------------------X----X--------X
