----?---ME----oE---o------------------BB----E-------------------------------o---X-E---?--X---XX-M------------------X-----------o-o---?-----XB---X--o-----------------X------o-M--XB----X-----o--E----Mo-
------------o-------------------o---------------X----------------X-----Mo---------E------o------------X?--B---o--M----------------o----------o------E-X-E-M-----X-------------X-------------o---EX?-----
--------oo--B-----X-E-B-----?----B-----?------M-------------X------------------------------------------X?-----o-------?----------?M--oX------X-o--------X------B----E---B---o--B-------o--E----X--X-XX--
-B----MM-B------X--B--X---------E----------------B-------------------------XMo---B-MX----M------M-------------------------B------------------X----X-X------------o-M--o-E-------------------o--------Xo-
------------o--------B---E-------M-------------------X-----EE---------o-------------X---o---------o---------------E------o-----B-----------o----------o---o----X---------------?-------------------?B---
-------X-B-------o-XE?--------------------o--E---B----X---o-------------?---------o--------E-------------------B------o------B---------?-------------------o--B-E-----------------B---M-?-----?o--XX----
------?-Mo---E--X-E---E----o----o--------?o--------o-----------o---?-----------o-----o---X------B----EMB----E--X--?----B---B----------------M----o-------M--------B---------o------?------------Bo--B-o-
-------------X------M--X--------X--?---------M----------o-o-----------oo-----o-?------E----X----------?---E--B---X-----------------------------X--------M-o-----B--?----o-------------------o--X--oX--Ev
----------X--M------o---?------M----?--------------X--------?------------E?---o-E------oX------B----------------M----------?--?--------------X--o---o-ME--o------E---------E------XB---X--E-----o------f
------EB-----------------M-----oo----X-------------B------------X--------o-----X--------------X---X-?o---X----M----X---o------B-----o----------B-------o-----------------X--------X--------------------f
----------Bo--B-----o-B------B------B------M--------oMM------M-B------------M-o---X---o----X----------------X--------X-----------------?X---?---XX---E----------------o-X-E-----X------------o-----Bo--f
-X?M-?X--?---X-B-------X---oX-----------------X-----B---?-?--------?-----------?------B------------------X-----ooX-------------------o-------X---X---------------X--------------B---o-X---------------?f
-|--T-o-oE--X------BT----oXXB-E-T??MB|-T-------T-----T-M-M---?-o-X--oE---X--o---|--B-T-----X--T-oMT--T-oM--XTX---B--T--B?T-T---ToX-B-E----TT----||-MT--o----|T----E-XX----XT-----X-MoTT--T---TT--------f
-M-B---B-XMBXTB-E-X-----oT---|oB--M--X----B--TXo--TET--X-?T--B----|Xo-BT-XT?-B---T---------o---T?B-oo-o-T--T-------M-XB----E--E---X-oE--|o---T-EB--T--Bo--E------M-------BXT-------X--o-E?--oo-?----T--f
mo-B-BX------|o--o-T---XM----TX-T---X-X-E---T---o-MX---MMB--T--------B----T--M--MoT--T-|--?--X----|o-M-E-XE----?-?BT--T---TM----To-T----?--?---T?|--T-T--TT-----ToTXEB---B?o--M-?--oT---EoE--oTM?-?-TT-X
XXX-X--X-XXX--XXXX--XXXX-XXX-XXXXXXXXX-XXXXXXX-XX-XXXX-XXXX-X-XXX-XXX-XXXX---XXXXXXX-XXXXXX-X-XX-XXX-XX-XXXXX-X--XXX-XX-XXX-XX-XXXXXXXXX-XXXXXXXXX-XXXXXX-XXXXXXXX-XXXXXXXXXXXXXXXX-X-XXXXX-XX-XXXXXXX-X
