-------o-o--X-X--EE-----?B--?Bo?---o---E-----o------------X-------o----?---o-----M----------B-X-------X--------Bo-X----B-------------------------M----oM-------o------------o--------o----B---o---------
--------X-?---E--------------?------?-------------X---o?-M-----------o----------------B------X-------?----------B---B-------?---Bo----E----X-------?--B-------------M---------M-?o------------------?---
-------------------B?---X----X---------------------o---------BX---------o--------?--------------X---X-B?B-M-----X---------o----E---B------X-------B-------M-----o--?---------?--------------o--------MX-
---------X----------E-----BM----X--o-oEo-----------------X------?-----------------E--B------------------------M-------o---------o------?X-------B--X--------X------o-------------X--oX---X--------------
----X--o-----o--------B----------X--------------------oEo---X-------------BM------?--X----E---o-------o----M--------X------o--------E---B-E-------X-o------oE-----o------------------o----------oB----o-
-E-M----------------------------o-----X-----------------------E--B--E--?-E--?---X-----M-------??o----B--oE-----------X-oE---o------------X----------?---?--------------------o-oo-----X-B-------E-o---X-
-BB---?--o---X---B---M-------X-o------M-B---------------------------B------B---?--E---o---o--o-----o-----B--o---E-----------o?----------------------------B----------------?-------------E-----------M--
------B--------B-----B-------?E------X-------------M---B------------B--o-----B-------o----o-------o-----o----?---E------------o--------X-oE-------------B-------------------X------------o-------------v
--------------------B-------?--E?------o-M-----------B--------------------X-----o---------X---M---------------------------B-----------------?---------------M---------X---?----oX---Bo------E----------f
-------?-M------------o----------E--------o---XM-------oX----M-----------?------M---------?Mo------B----------BM--E-M------------?------M----------?------X----?--------X----B-M---------------------?-f
---------?-----o--X-------------X---o-?-------EM------------------E-------o--------------------X------------------B---?--B--------ooX-----o---------B----?-E-----M-------------B-----XB-------o------o-f
------------------------o-------------------BM----X---------X-Bo---?--------------B--o-X----------M----XE-------------X------X---EX----o----------E--------------?---B---------o--E---------XX----E----f
---?-B-o----T-E|-T-E--oo-XT---------|----M-X--o|E--X-o-----?|--------o--------E----T-?T--------ET-T-X----oT-?-------M---T-----XM---XETMT--??----?--o--B-M----T---EE--?--T?E---?o-T------|------TX----|-f
------|------B?--B-o--E----?B-o----?-MXT---o----------T-XE---T--|----X-----B-?-T--T---BXT----B-XE---TXM--?ETT--M--T----o--oT|Bo--X---T-MBo-XTXX-TT--T--|-X-------T----M----|----TB-T-B-----------TXXME-f
m-----X-oTE--BTXX----o-E---M------------T---?-T-o--T--T---B-|----XEE----??----o--T-M----X---o------?T--T---o-------------o-T--T-o---B-X-----TET-T?---o--T--------X-o-XX---T-?X--Mo-X|?oT-|----T--B---XTX
XXXXXXXXXXX-XXX-XXXXX-X--X-X-X-X-XX-XXXXXXXXXXXXXXXX-XXXXXXXXX---XXX-XXXXXX-XX-XXXXXXXXX-XXX-XXXXX-XXXX-XXXXX-XXX--XXXX-X---XXXXXXXXXXXXXXXXXX-X--X--XXXXXXXX-XXXX-XXXXXXXXXXXXX-XXXXX-XXX-XXX-XXX-X---X
