-X-ET-BoXoE-TB--TTXT--TTE--E-B--TET-?|X--|TTBo--|oXoooTTXXXoTT-oX-T?TETTTXE-TB--?-?X-?-X?XB---X--|-|-ToTXo-M--B-|-oo---|TMTT?--To-XEB-?TXoXMT?oMBM--oo--EMXM-EX-oB-XX-BB|--|T-T----TEMTTT-XX-TX--T-o-X--
-o-o-X--BTToTo-MT|ToTX?-XE-o---ToB-?X--B-XTB??-TX-B?B-o-o-XToM--To--?-X---TToX-|o-----oM---EXB-TE-T|BT|B?B---T-TXX--TEooXoXE--TMTB-?-o-ToToBMTBToE-BToBEEX--X|XB--?oE-M-ToBXMTTToo----E-?X-?B-TT-o?B-X|-
---X-o?B-X-ooEX-XTBT?--E-BT?BXX-TBTXT--T-XXXXT-X-ME-T-?oBB-T-BTo--Too???M--?-XX-o-?XT-X---o-oTT--?--T?--?-----T|?oT-T--|-o--|o-MT?-T?BTToTo--E??To-MTooE-X-T-oMBoMT|BTT??-ooE-oBoXT-oT?TTT--|BTooX?|TT?-
--T-T|B-XTX?ME-B-XX-o-E-M-?T-BEXXTE-M-?-TMM-TXTo?XXT-|XMT-B?-T?XMX|oM--MBM?oM--XETTX-|--TTTBTTB?-|-M-T-T?Xo-oT--B--TT-XXT-B-E-?XTXX-T-o--o-?o?E-?M-XXE|XB-BXoMo?-o---?--T|MoMoXoTTTT-?-XXEXTX-T-o-M-?oT-
-EM---XX--?E---ooX-X-oXoET--T---XX?-o--?--|M-TXTXEE-|X-T-TEoMX-ETo-EE---XT-T---E--o-XXB--X?--X|?E?M-oT|-EM-MX-BTT---TXoX---M?oX-oT-TXTMMo--T-X|oXBME-BBo-B|?-?TX--o?-TToTT-?-T--o-TXoM--o|o-XXT-o?T--XE-
---oEE--E-To--BTo-To-B-||---Eo?X--T?B-oT-ET-Eo-----B-oB---ToTTTMM----T|T-oo-oB-ooX---?-XBM|o|ET-?B-|BT?MMMT|Xo-o--oT--TMBX-ooo-o-XMB-|X-?-B--X---TT-Bo-X-T-EMTT-?TXE?-M---oT--XX--TT-EEM-oo-T--TB--B|TM-
-XE?oTo?E-?T-TMo?oT?o-BTXX-X-XB-M-o-oBT--BT-?-MB---EBo-o?E-MB--?-TTBoT-TT-o-T?T-TBM--TBBo--T--EEE?---?--E|M-B-XoToB-TX|T-XBTMT-?o|---T--|--TT-TBo--|?-TXB-EB-MT----o-T---X-X-M--TEX--E-TMX?T|--?-oT-T-?-
----M-TBXoX?-MBTXMToT-M--MoTXM-BoTTTT-----BX--ToMMX--T-oXBTB-T?o-T?B--BXoTB-?-oTXX-?B-TTXTTME??ETToo-BEXE-BX--X----?M--XXo|MTBoT--BT|-E---To--E|TTo-To?Xo----o-XTToX-o?XEBT---oX?-|EE-oE-BMMoo-Bo|TE?--v
-BM--TBE--XXooTXT-?TXTTT-M-ooM-oX-o----oo-TXT?X---TXTB---TT|B-XX-|-XT--oXoTTTTXoT--TBTME-oETTM-E--B|E-?--oT?X-|X--BoM-BT-oo?--o-ToM-E-BE-ToT-To?|o---o?-M|-M--|E-o-?|TX?-EX--TX?EXT--o|BoX-XoB-XToXTM-Mf
--o-oT?X--BoB----?----Bo-oToE-TT--ETT-X|-MXoET----MT?-T-XB|-TTX-|MM--XT---?-oE-T--T-ToBBMoM--TEM-oT-B??BoooBEo-MXTTBTTo----|-E?ET-EToB|XT???-T?-T---T--|-X-BE-|TB?--XXX-o-ooX||E-T-M-MB--TM-o-?-TM---XTf
-?BT-?BM-T-TT?----XoET-oTooT?|T-T--M--TT?--M-ETX-oTo-T--To----TTXXX-B-E-o?T---XTB--o?-EXX-XT?-X-T-T--E---MTT--o|-T----BTX-M--X-?o?TXT-EBXTo-XBTE-Bo-X|-o??--?TBT-T-TT|E-TX?TTo-TXT-TM--BToB?XX-ooBBBM-of
-T-|To-BT?XT|TE|ToE-X----oXEoX-?TTET-Too--T---T-MoX-|-ooo-E-MXBXT-XooMXoooB-oX--T--X|-X?BTT-|----o-oBo-BX?--?-XTX?ToTTo-TBBE-T-X-T---X-?Too--?E---MoTT-oB?T----BTBTX-TBM|--TXE--BBMX---|EE-T?T-T-?|M--Tf
---oMBM?--|EEB-oXXB-o-B-E-oBEBMXo---oo--XXM-E-ooo-EM-EME--MBo-TXo?o|E?-oE?X-ME|BXB--??oE?B-BE--Mooo-BB?o-XX-B-X-XM?E?--oMXoo-oE-BB-MBB-oXM?-M-o?BXTXBoBT-|BXX?--o-E?B?-B--E-o-X--?o?-BoBoBBo?BXBMM?E--of
-BMTM-B??M--MXETB-XXXBBBo---BB--EB--X|E-TT-X?-?o--XoTT-EEM-BM?--oX-?oo--oXT?o?-oooB--oo-MX-?-Xo?oMXXo?o-?B|?-|-EXM|o?oX-MX-XBoX--X?XBXBB-BMBoX-oB-B-XMXM-oXBMBMo--MBX--o-BX-?-X?-?o-MM-oX-B-T--M--??M-Xf
m--o-E---MT---MET---B-?XE-EBXo--TEB-B??B?---BXBo|M---?BXBXB-|BEB--?BBB--EX-oo?BX?X-XXXoooM-XET-XX-MXoMBoX--B---BoMB?E?B-?o?B-BX-E--oT-MBB?EoBTXB--BMoM?MBBB--?-X?-o??XB-B--XT?-XX-oBX?E--X-o----?XMBX?oX
XXXXXX-XXXXXXX-XXXX--XXXXXXX-XXXXXXXX-XXXXXXXXXX-X-XXXXXXXX-XXXXXXXXXXXXXXX--X-XX-XXXXXXX-XXXXXXXXXXXXXXX-XXXXXXX-XXXXXXXXXXXXX-XXXXX-XXXXX-XX-XXXXXXXXX-XXX-XXXXXXXXX-XXXXX-XXXXXXX-X-XXXXXXXXX--XXXXXX
