---o-----XXoo???-?-XXX---BXE?-?B?-oXXE-Mo-Xo--?XEM-?Xo-X?--B|-?-o-XEoXXMM-ooX|XMXBo-E--?oX-MXE-TXBo-o------BBo---Moo--?|?-oE?B?--o-?XBX-?B?--?MB-XoT-oM-?-BM-oo-X?BM-?-X--To-B?-o------o-?-?XoB-BMB-E-M-
--BMM?XX-oo-?B-?--EoE--?|X|?--?B?--oEXXXMXo----o----MEX-??-E-o-o--X--X-B??XM--|X---?-B---Xo|-ooooEoXXXoM--BoB--?M--XX-X---EEoX-??---?o--XE----o-XX-|oM-?B-oXXT-B?-oXBT---o?MX-o-B-XBE-o?o-oXBB--Bo-EBM?-
--X----XX?-?ME?X--oTE---E?XM--o-MB-XBXEE--EM?X-o-??--o-?-XoXXBX--XX-EM-EB??o?XX-oM--?oX?X-E-o-?--Bo-oBE-XEE??-M?oX?XXB-oXo?oB?BX-?-o--Xo-E-?B?-X-MoX--X-EX-X-?-BM-B------Eo-B----o--X---?-o-----ooT-?Xo-
-MB?-M-TX|X-?-E|E--XXoBT-o-E-BX-BXE-?E-BoX-E??--?-X--o-E----BM-B---BE-?-oBE-M--M|o-BX-E-?T-?B-BX?M-oEX-?-XB---oBM?M-X-?--EX??EMM---o-?-X-E|--X-M?-E-M-oX--BX?EM?---o-X-M?-EMB-XE--BBX|--X-X-XE??-ooXXoo-
-B-Xo-MEXMEXB?MoXX-o-B|M-EoXEE-E-X?TB--MMMX-o-B-oM--?ET?-EM-BX-XBoBEMo--BX-X?-B-X-EoX-??-XX?X-|-oE??XoM--E--E--?-?M?o?X-E--?XBXX?ooTE--X?BMXXoB?-XEoo-E-MXo--?-XX-E?-B-X--X|--?XT-??o-B?-BEXX?B-E?E-X?o-
---X-XMB|-oXXX?-E-E-B|X?-X--M-X?-ooM--XoEo-----|XX-----??Xo?M?----B--M|Xo?BBX--X|----B--o-XX--MX-M----MXXM|X-?-XE-?o-?o--XMM?---?--X?oBoB-X-B?-X-XBTMoM--X-M-|-??B-Xo-XX?B?o?X--?-Eo-B--Mo?oMMoEX|?-E?o-
-Xo-o--E-BX-Bo??XME-MB-MEXXo?-o|-X-|MB---X-?ToXo?X--MB-|o-X|--o-XXE-ooo-|-B|MXE----?o--XMX--?MXB----|XEM-oX--o---B-BX?|M-?-BX-o-X-M-XXoo??--M-o-Xo--o-TXoTX-oTo-|---B-o-X?X-E---EE--??--EMBE--BB-MB-----
-TX-Xo|X-X--X--o-??M--B--X?--X--X?-Bo--|TX-XB-ooo?oXo---?ooo|-BXB-XB---B|XXTX?--oB-?B-XX-Eo-M--Xo--o-XEXo--BBo-??T?|--M--X?E?-MMXoo----MX-X--X?o--EX--B-oB-EEE??BXEo|E--BX-?---X-X|o--M----XMX-E-o-ME?|v
-|-TooXM-X--oX---oT--B-?oooBB-?-?E-|o??-E--BoBEoM-o-?-EX-oB--MBE??-o?M-BXX----T---E-M-B?o-EME--?-T-?-----XXBXM-o-X-X----??o|X?-o-B-XE--X---X--o----X-|-----o---|M?XXBXX---o-E-X?-?M---B-?-XXMEE?oX---XXf
--oB??--?oMXMX-B?o---oXE|----?-B---oT----EEo----XB-X--?-|B?B|--M?BX-ooo--X--|-E---oo--X--EX--BXo?--?XTT-E--o|T--X-M?-X--?oEEX-M-oEX--E?XX-X-M-B-?o?-?XBX-EX-Xo-XXXE-?----B?B|??-?-B-X-oMBE-X-T-?-?o?oBXf
-oX-XM|--XE-oBXB-X--X-|---X-?oMEETTo-??X-M--X?-?----X-XB-o--?EXBoX??X--?X-X-X-BMMBooX-?MXMB-o--EBXoXXXX-o---o-TX??-Xo-??----o?-M--X-??T-o?--?o--?E---T-----E-------XoXM-o?B-|-EoMMTo---X-?Boo--oXEX-Mo-f
-?E-B-Xo--?o-XEo-ooMB-o-EX--o-Mo-MB-?X--o-E----X|XoX-E-To-EX-M-?-T----B--o-E-T-o-?XX-o---ooBB--XEo---B|X?----XX-EooX?--?Xo-X?XM-X?-??XM|BXXE??-EBXo--B--XXB?oo-EBBB--oo?-X-BoE?-X-EB-B??ooMX|?-X--?--oXf
--EXBoB---oMB--BXXXT?--oMBB??Xo-oTB-X?TT-|-EMBBEB-TXB--B---?oTT-BB-XBB--XX-oB-M-EB--BMoE---M-XX-M-X?-XM??Bo??MX-?o??-XMBo--BXB--M-o-o?XMM----B-E?o-o-XB?-X-?-XoEBoXoMo|---TooooMBB|---?M|oBE-oEoMoMBMMBf
-?XBBXoM?-X?XoBBX---ooXXE-XB--XX--oB-oE--BX--X-EXMX-B--X?E-E?BMB?-B-E-??-B-X??MEBTB?T---Too|XTBM-?XEB-BoM-|oM----Mo-?--BB-M-?--o-?ooEXM--MoBo-X---BE-Xo---XB-XXB-XX-XB--X-o---?----BBX-T--oXB|-XBX-?B?-f
mMMX-X-X--o-B|?E-M---MTo?o-X?-oX-B-X?-oB--o--o-BBXX--?XoBB-EXB?-BMB?-XB--B-TX|ME-M-MM--?B-X?-?B?--B-oX?XoE-B-?B---oEBXBXBMo-X-o--E?||-EMBB-X-?B-MooMX-?M--Xo-B?BXE-XX?B?oM?X?-XoX-MXM-Eo--o-Bo-|-XBX-ooX
XXX--XXXX-XX-XX--XXXX--XXXXX-XX-XXXXXXXXXXX--XX-XXXXXXXXXX-XX-X-XX-X-XXXXX-X-XXXXXXX-XXXXXXXXX--X-XXXX-XXXXXXXX-XXXXX-XXX-XXXXXXX-XXX---XXXXXX-XXX-XXXX-XXX-XXXXXXXXX-XXXXXXX-XXXXXX-XXXXX-XXXXXXXXX-X-X
