----X----------o-------M-------------?---E--X-----E----o--------?---------M----?--------------E----?-----B-o-----------B----------B--B-----------X--------------------------X--X-----------M?--BXo--o-X-
-------M----o---------------------ooEX----o----B-------EXB----o-E-E-------------?----------------------X-----------M---B----------------E----------------Xo---B----------X---o--------------------------
-B-o--B-------o-----?-------------M---MoB------------------------E----------------------E---E---------M-----o---M-?-?-----------X-----------EE----?-----?------M-------------------------o-----------E--
--X-X-----?----Eo-----?----XM-----M-o--------M----BX-------------X-?--?-B---------------M---E-X-----------X?---------M------X------------o---------Mo--E---X----X-------------M-----?o----?-------o---B-
------?X--o----------E--------E-XB--------X-----?-M------o-----B--BX-X-Eo---oo-------B------X----------X-----o----------------M-o----------------B--o----X--X-M----?---E--E--E--o--X---X-----B--------X-
---------B--------------M--------oB-----------------M---------------------o-E--o----B--M-------?----------X-----o-Xo---------------?----X----o----o-o--X--------B-B?-------------o--X----------B---Xo---
--T?--B-EEo?--?------?---------BX-E-X------------M---B-----?--M------?B-X--?-B------------B-----------?---oE----------------------?---------?-----------------------B---?--oM-----M-------------------?-
------------M---B-------B-----------------------------o-?-X----X--B----X-----XB--XB-o---EE--?--M----X----X-o--------M---------X-?----------------------o-----------------------------------?--E--oo-oX-v
----o-----------?----E-----------------------E------?-o--M-------M--B-------?M-o---E---X-E--o--------o---X-----------X----o---------------------------BE----MEoo-------M--X-----------------M-------?--f
----?--------o?------B-M-----E-o-----------?---?----------M---o------------------------o-----------X----------o-----X------?B-MX---------------o------------B-Mo-----------o-o-X----------------EX-----f
--------o-----oB----------X---E-------E----E----EX---Bo--------BE-------------o---------------------------?--BXXo----B-----------X--------------X------------------M-----o-M----M---E---------------?X-f
-----XM--?----------?--------o---E-----o------X------o-X---E----o-X-oB--------------------------------------------E-M---?-----T--------XE-------o-------------?--M---------MX------------M---X---------f
--------T-?o-?--X-|X-M----XT-MoBo-??--o|-X----T-----|---X?-T-B|----?---B-B--T--B--X---TT---T-X-T-Bo---X-Xo--BT-E--oTE-X-----M--B--B--T---BTM-o---TM-B-?T?-?-T-----X------------oE-----?o-B-T------?To--f
-----TM--T---E--o|X|-EoM--E-EM-BTM----ToT-----o-o----T--ToXBo?-B--XB?-o-?-XX--T-?|-E-------T--X-XX--E---E---o-?XT-B--o-T-E-EEM-XT-M-T-M---T?----T-o-------TT---MXoo-?Eo-MTBoo---o??oEM--TBB-T--oM----B|f
m?X--TXB-----T----|-XEE--E---T---T-o--E--T--------ET--o-E-X-M--------B----X-----TXT--??-------ME---Mo|------|XX?------M--T--oTTM----X--oTTXB-o-?--?--XEXE-?TXT--T---?---oo-|--T|o---X--o?-T--T-?-?X--X-X
XXXXX-XXXX-XX---XXXXXXX-XXXXXX-XXX--X-XX-XXXX-XXXX-XXX-X-XX-XXXXXX-XXXXXXX-XXXXXXXX-XXX--XXXX-XX--X-XXXXXXXXX-XXXXXXXXXXX-XXXX-XXXXXX--X-X-XX-XXXXXXX-X-XXXXXXXXXX-XXXXXXXXXXXXXX---XXXX-XX-XXXX-XXX-XXX
