-BXM-?---TBMM?---|o--------X-o?----------EX-B--|-X--??X?oM--|o----o-X|B?B---|M---oET-M----X-T|X---?---|E??-BBB-B---|---B-TM-T-----?-|T-T---T---o-----X-o--?M-??X-TB?|--T-T---E--------E-----------o-XX-X
--M-?---BME|---XX|B--M---E-?---TTo-------XE-B--M-------X-T------B|B?----T-X--|---Xo-E?-B-B------|o---M-----BE--MMTB-?--M-T---E--------E-----?BX--?|-o-|--o-T-o---|?---M-TTX-B-T-B-------M-M--oT-|--T---?
-------M-------X------?----B---TB--B-----------XB-oo|-----E-E--?TT-?B--|--T-o--o---?-E|-oXB-------M-o------B-B----X----|-B----X-|--------------Eo|-Eo-B-|E-X----BX--T-----------TX--T-----------E-BTX---
-|-----E------M------------?-M--XX-----?-|-?-oM--ETE--T---X|----E-------E---B?o--ETEMM-X-Xo------ooM--oT--|-o--X---EMTTE?-EM--M-M---o-B-XEX----BE---|M----X-----|B-X-|-M-TE-X-T--BTX---?-T--X|M-?MM----o
--?--TE--X--?M-?---T-E-B--------------|MBE|B|B-X|---X-|-o----M---T-o??T-|??-BM----B-|-|---|oTT---o----BX----T---E----|X-----E--B-TX-E-X--TM-?o--TM-B|-o-o--o--BM-|--o|-ETTXX|X--B--Eo--T-M-------TM-Xo-?
--X-||-T|-T--------XM?-o----X-B-MBo-o|-XXXEo-BBE------E-MT------||---oX---?--T---X-X-TT--T?--X?---o----EET?-XB-|--E--M|o-?-----X?-----MoMoEX-B?M--?------MB--X-B?---------X--T--|---o-|-BE--------|-?X--
-|-||X-o-|--E--?---------o-E--?XE----B-EB-XTM?-T|E?-------T-Xo-o---|--?-B-E--TXM--------XX----oB-?o|--M--X-E---||-|?--MoM--M--------B-E------X-E-X-----E--X-E--o-|---oX---o-|----o--E---E-|-XM----TT-?-X
--?|T-oEBo-E-------||---MX--|-B?---B-MB|-oB?-?-B-Mo--------X-T----|ME-|-B?B-B--?X----------M-B-?-M---M----?---?MB-T----T---X---------|M-?---o------M-oMEX------X--X--E--|---o-M-o--?--?-----|?-EEB------
--?-|oEo-X-M-|-E--TXBB------o|-oX-B-E|-MM-E-X-?-B|X--TB-T------Bo|----T-o--B----|E-TE-M-B---XM?-X|o--MT--|----T------BMT---------|---XTT-X--ET-o--X-B-M------E--B|----?T-X?-To------o-|-oEM?------B-----
---------T-T---X----o----T---|--XX--T-TT-M---X-|-|-EE|-E--|?--E----------------B--oB--|-M-|EXEE---M|E-------||X-----M---B-M-----o-|o|o-----M------BE--B-------B----TM--E---ME--M--|oMXT---EB??-|X-------
-|-oT-B--EM--E-X----E-----o|--B-M--X----T----?--oXE|---|?--T?-o-B-M?--T??X--|-B-M|--?B----|-----MoT-E-|---?----o---o-M-B----B--?-?--|-|------E-|?|-|--|-|MT---?-X-B---B--o--o--X--M----|-----o-M----ETX-
-----Eo---E--o-----XE---|M----X-B------TM---E-M-M-T?---------T--BT----Bo-EX-----B-oE---o----|Mo---T--------M------|-?---To---?-------------------------M---?--B-------|B-----|-M--E--?-------B--|---T---
-o--T-M--M-----X-?--M-?MX--?---T---o--B--o--TE--?o--------BB-|--||-Eo-T-----T--B---|---E-----XB--BMB-o---M---?--?--B---M--------EE----o----E-------o--o-EX-o-E|---------XM--T-----BB----M--?ME|-M-X--M-B
---|TTB---B-|MEo-EMXXM----?--M------oo-o-o-----?B----|---oXB-B------|-o?-?X---o--o-|o|-?---ETM?----TBM----EM-?----E------o-o------B-?---------------|M-M?B--T--?-----E?----------E---|---MT------M-M-|-|
-M?-T-|-|-X-----|-o-?M--E--|X--To-E?--E-?-X---o-?---BB----?-------X|-------B-----?--B---X-M-----BBT-|M?-----------------o-----XB---------B|------o---BX-?-M-Bo-----MEo----X----oB--M-?-----XBT---------|
-XXXXXXXXXXXXXXXXXXXXXXXXXXXXXXXXXXXXXXXXXXXXXXXXXXXXXXXXXXXXXXXXXXXXXXXXXXXXXXXXXXXXXXXXXXXXXXXXXXXXXXXXXXXXXXXXXXXXXXXXXXXXXXXXXXXXXXXXXXXXXXXXXXXXXXXXXXXXXXXXXXXXXXXXXXXXXXXXXXXXXXXXXXXXXXXXXXXXXX-
