-EoB-TT-XET--TB-EXM-X-oTT-T-T--?-o-oT|T--T--|-oT--TT---X--X--?o-|-EE??-oBTo?TB--To-?X?B-TTTBEBoTE--?|E?XTBTT-TTX-XoTo-Xo-TME?-?T--o|-|-ToX--o----TEX|-X-X-?-o|o---T--o-o??|T-TETME-?E--TXT-Xo?ETXT-oooT-
-XX|X-MMoT-TXT-T--|-T-B-T-TXT-|--X-T-EXB-oB|-MB---TTBX-M-o-?-T-ToT--BoET-T--BoXEBTB-TT--o--MTB--o-To--o|TXoBTTBT-oEBETM-?oBXooX--TXX---?---oT---|MXT-TMT-TTooTM-?TTTB?-BT?-|BET-o-??EMX-o----?-ooEEooT?-
--ToE?XTXX--oB?-T-E-TMB-|?--oEE-EoBMXXM?BX----|-TM?o--TBEBXBTo-MX--o-T---oBE?MT---|ToBX-XX?EX|oBTo---X--o-?oEoE-B-B?-E-oBEXT--MXEXMB-TTMET-XToT--To---BMX|TT|--EMTT--ETTX-M?XT--oMB---TE--T-TBo--|oE?-o-
-TX--TXM?-XooM---TB---EXX--?T--Xo--M-E-B-EoX--T-?ETEX---EXT----?-?X--To--oTXM-X-T--EBB-XT-Xo-X-TX??BT-BTETBT-E--T|---E-E?----o?-T-TBX?-oT-To-Xo-oTMX-B------o?-M-EB?T-T-----BTT?oX?XXX---BoX-?--o|M-BBT-
-|---TB|X---T|X?-T-E?-EBTTTT-?B-T--ooMo-BooTM-?TX?--o-|?oX-TMB--TM-To-T--X--T-oT-?-oE--?|TMoX---TXT-TTX-T-o--oB--|T-E-o|T?-TM-?-TE--o--TTo--T--B|--X---X-oXB--oX-Mo?M-E-MMBXo-o-TXMT?-Eo?o|T?o-Too--T-T-
---B--oX|E-T-M?MBoo--|E--?XToT-XEETo-ToB---Eo?BB-----T--TToX-?TMMTM|B--TTTo--T?-T-T?oT|?-||XoB--X--BoTXoM-|-XTX---|METoTT?X-?E-??-To-X---B-?-X|-T?XBXE-o?MX-?-XT---XTo?E--TTMMMXoMT-TET-o-T-ETo------Bo-
--?T-o-T-BT?TXToTB-B||TME------?oETT-oMooTX--B-o-T-|Too-E--X|-T-T-B--T---B--T-o--|?oT?-MTB--|XoBoBTTXBT-|-|MoX-M|o-X-X-oo--T-XBTEToM-|--M-o---MXo-?--EX|MoXM-BoT---ET|B-TX-TXo--T-o-M-BXoX-E?M-?TTT-o-T-
-T--X?TTMT--BTM?X?MB-TTMoE--?MTX|--TTEoTMEXMX-EXX?B---X---XoTTo|--ooToB-MB?X--EB---oT-BoTTM-?-oT-oTX--XX-o-T?X?-TT-T---ToXo-TX-X--?B?-TT--T--oTT-M-oTXT--o-|X-T--MB-B-TTM|--o--?T??X-TT|B-M--EBToE-BX?Bv
-?T-Eo|T-TTT-To---TXXoXTT-?-XTTT-TTT--Xo|BoM?BETM--MXX-TT-TET|-?E|---B--X?-oMTEE-o---T-BE-TX--TB?X-X-o-B?BT?-T-|ooBTT-X-X-|XoB|--T---E-B---o|TTT-oTE--T|TEoE-X---o?-BT?-B-TM?M---TXTXToB-oTo-XTEo?-B|Xof
-X-B-TT-X?B??-XT-To|XoTX-?T-XMT--TX-X|XM?-ToMTMBo-Xo-X-T-?TMMEoE--TEToT-|---M|-MTTX--T-MMMT|----XM|o-o---o|B--TTo-----XTE--T?--TTT|EooX??T|XE-?B?--?M-TB-o--X-|E--?-o-TBB---T-T?M--BT-|----TMooTT-BT-X-f
---?-oo-|-X-||X|BToBTTTT-ETTB?MM--TTBT-oT-ToT-??Bo-Mo?-X---o--ET---MTo---|--o?-?XX-XEXTXoTB--|XTME-XXX-?|?-XToT|--ToT-M?T-XoM|oB-o-?-T--T-XoM-XE?T-??-|E-T-TE-o-X-TTo--oXT-T-TE--ET-?E-?XM--?-X?XET----f
-TT?-|EEEBo-o|T-?-X-?oTBo-XT-T?TBTB-||oo-|XM-o-----o-BXoEoE---T-?TooM-MXo-Xo-TT?ToET-MTo?XX--?XB|--?TTTo-Eo?XB--BM--B-TB-|-----?TTXo--?--oToB-B--?-oXB?TToo?oX|?TBo--?--BTTBooEXTM-XoX--TBMT?--T?ET-B-Ef
-XBE-XoB?M-XM|M---o-X-BM?E-EooX--?Bo-oXMM?X-?-BB-?|-XoM--oXB??-BMoXBXMo-XX-?-T-?--X?XEXX----?X-B--BoBX|-M--Mo-oBoX--?X?T-?oX?B-?-BXXXM---To-X?-ToM-X-X-|B--BXB-B?XX-XXB|X-E||-?--?-X?-BTBX-EX|-MMoTE--Bf
-BMB--BEX|-BXBooBEBMM-oXXoEX??-?B|?X-XoXEMX--B-XBoBB?o-M?-|o?T?-?BoEBBBo|-o--XX?-Mo?B-?M-BoE-o---M-B-?-T-XX?B-BB--o--MoX-B?XooE--M?oX---X|B?B?--MEXX-o??XB-EM-?E-Eo-E-B--o--?--?o-oXEEM?X-EX---?MoX----f
m--MX--B?-B-EXoBE---o--XXM?----XMo-B-X-------MoEoEX??X-o-B--o-B--XEo-BT-XX?XXMXBXB-BTM-o-XXE--?-o-E-o-|X-M?o-E?BBB|-oX-B?XEo---?BB-XooM---Xooo-X--MMT-o--MB-BBBBo?--B-X--oX-BB?E?BoX?XBBBX-----B---?o-oX
XXXXXXXXXX-XXX--XXXXXXXXXX-X-XXX-X-XXXXXXX-XXXXXXXXXX-X--XXXXXXXXXX---X-XXXXXXXXXXXX-XXXX-X--XXXXXXXXXXX-X--XXXXX-XXXXXXXXXXXXXXXXXXXXXX-XX--XXXXXXXXXXXXXXX-XX-X-X-XXX--X-X-XXXX-XXX-XXXXXXX----XXXXXXX
