----M----o-o-??-B?-M-?--------X?----------B----X------?---T---X?-XE-|M-o-?--B--?---?-X-----?----XB--EE----T?--?B-B----?--X--o---BoBM-B-M-?-o-o-------B---o----BB--o-XB?-E-?-B?------E-E---??B--X---oB---
-o-X--B----?---ME-B-----X-X-T-?---M-E--------o-M-X--?--XB--X-MB-M-------oBB----oE----B---------EXE------o---M-oB-----X??--?--o-------o-MXBBX-XB----?--M-Xo---B--o|M---BX-M-M-o-B---o-M---M--?oM--?-XXX--
--X-B--X-?-o---?--B---X?---o-o-BXX-E-----?M--?--X-X--M?MX-?-T-XTo--M----o-------M-o-----X--X-BTB--B----X--?------E--X--X?---T----o----B-----o--X--BBX-XM---EX?X-?----X-B-T---o--o--M--B---X---E--B?-----
------B?-BE-T---?----o--X--o---?B?-------X--M---B-BE-X-MX-BB----EE--M-B--BooE------MM-E---B---M?XM-X-oo?-------?o-XE----oX-B---X---B---?M-?--------E-X-o-X--EoM-M|?--X?---?---?--X--oE---o-----|---M-B--
-oXE?--X-----B--?E-BoM-B----o-B---T-BBM---?-----M-----X--X--X---XX-X--BXB----o-X--BBE-MB-o?B--X-X-M-T-Bo--B-B---BB-?Xoo-------E---XXE--B--?-----X---EX-X-X-B--B--------M----B-X---BB----------oEEoB--oB-
-oX?Moo-T-------X?--Mo-E-BMEB|------B--B?Xo--BoB-B-oE--X-----o?-X---M----BM-M----T-X-X--o-?-------XXoo?-?--X--X---------E--M-----T-?--o--?--|---XE--XXB--|------XB------X--o-?---M-o---X------B-B?-?ooB-
-----MT--?MX--EB??M-----o--X-B-o---------B-MXX------B--E----BMEE--?-o---X----B--T-?X--B?-X?BE--MX----oE--E-o-o|---B--?-----?E-B-o?-X--E--?-------T?--o--X-----E?--MEB-?B---E?B-E?------B---X-o-|T-B---X-
--?-----?---?-BEE---------B----oB-oX?---o----------?---E-X-M-X-??|---M---BB----o-|--B---E-----XM-oo--B-----M--X----E---o-X---X-XB-BB-X-?----M----X--M--B--T-----M--B-E-----B--o---o?--XXB----o--o-B--X?v
----B-----T-----M--?----E--M-EX------------o---B-?-----?M-?--M--MX--?-?-XX---B-BXX---E--M--o---?Mo-??BX------T------B------M---X----B------?----X---M----XE---X---E-----?---?B--E--B-BB-----XM---X-|---f
---?EX---------X--B-X---|--?----B-----?----?-----??-?--B----X--B-MBBM---B---Mo-----T------------X-?-B---?M----?-------Xo-?M----------X-?---ETME-o-----X--E-?----M----o-------B?-X?B--XX|BoB---X--BXX---f
---o---|B?|----M-B--X--X---?----?TX---X-?B----Xo---B------oM-?--------M-----M--------o?---M--?-M-?----------BMM---Bo--|X--?----------BX--B-T--B-M-X--MoE---M----BMM------o---M-----Mo--------o-----?X--f
--XB---M--|-E------M?MX--o------BXX-?T?--B--BooB--o---?-B?E-B-X------?--B-MB-?-E----BB----M---o-----MX-----------|-BE--B---B--?--?-ooM---X--Eo-B-X-BB---MT-BX---XBBoB?-----X--o?X----X------X----X-M-|Bf
---X--oX--?-o--oE-T---------BBEB-T-B-----o--B-BX--------o--X--??--M----XX--T---T--B--TX-------B-?oBB-o---BB----M---T-X---?X-?----B-o----?-B-o?-------?XB---B--E----E----------B-----XB|X-o?-oB--oB-?-B-f
-Boo-o----E--B----B|-?-XXE----------?--E----B-B---X---oX--EB---E-o---??-oE-XB---------o-------Bo---?-o-?-Xo-B---?M--B----------B---------E?----?-----Bo--X--o---XXMBo--MM--B------Bo---M--XX--------|??f
m----MoXXM--X--X----B-M|--M---o---------X---BX?M-Bo--------o---EXB-TX----X---XXM--T--------------EM---MX---o--B-B--E---B----T----o----o?-----oX--?-B-M-o--E------??o-X--?----?E-X------X---To-?M------EX
XXXXXXXXXXXXXXX-XXXXXXXXXXX--XXXXX-XXX-XXXX-XXXXXXXXXXXXXX-XXXXXXXXXXXXXXXXXXXXXXXXXXXXXXXXXXXXX-X-XXXXXXXXXX-XXXXXXXXXXXXXX-XXX-XXXXX-X-XXXXXXXXXXXXXXXX-XXXXXXX-XXXXXXXXXXXXXXXXXXXXXXXXXXXXXXXXXXX-XX
