--|---M--B---X--E---M-|-|---X--B---EE--EM-XE-|?-E---ToX--B---BE?-|-|--B----M---?TM-ET-----|--X--X--X-----?--M----?oX-----------T-?--|-?-----TEX-?---M-----EB-EM-oB-E-B--MXT--T--o---ET------??------TE?-
---|-X??-X-|--XTE|-o-T--T?-Bo----M------XX|B-?-----------BB--T-?-B-E?-oX------|-BM---o?-M--X---------X---o-Mo--o---|-----B---M---?-------------------E-?|--------T--T--|B|---------X--------|--------XX-
--|o---B-B--oo-?|-------E-E-X||-T?---?-oBB--T--B-B-?----E-o--?-E-?E------?|----|-o--E-------XXT-B-T------M-M---MT-BB--o----------|--B-?X-TX----EX-|---o---B------E---XB--?||-o------M-?|---XE?|B-----T--
---|o---TM-T-E-TT-----?-M-----TM---M-o---T--oE--?----|-oBT-----o------X-B--|---------X-----?---MM-BE-|o-?-T----XX--B-----E-o---TMM-?--X?MT-|-|T?-T?-BE-----o-----|-X---T----T-------X-B-E-XM--|-X---T---
-o-B----T-?--?-M?o?--B------M---B---E--Eo-E-T----?|---?------------T--|-------B-----o------X---M---o-X-----T---B-----|X----?X------------|M---MBEB-?|--E-?----B?-o?-E--?X|---TE|-MET--oME--X--??-----?E-
--o-|--M?E---B-X---TXE---|T--B-M------M-|T-------?|------?-B--T-E?-----T-BX---E-o|----o---------X--E-----X-M?---E--?|-M-T-?---o-----E-T------|---B-ET-oB---B-------|B-B-----T--M-----ME|----|----E--MX--
-B-----?MM-o-|------M-----ET-T--------|M-E----|---|-?E--o-?-XB---B-oTB-M---?-o--o--E-oo-o-E----|-E--B--?o--o--EX----To-?o--MT-?|--T-MTo-M---EBX-Xo----E---B---X-X-M---------------X---?----||--?E-------
-M----oB--B---B-------------B-T--|---EX-o|EM|---M----M-|-E-B?BT----|E-|M?MB------T---E-----E--o--BT----?----B-------?---o-M--M--T|-----T-TX----o-----M-X|-oX-EE-M--|?B-M-o---o---M---X----T--T-?-----X-v
-|M-------XE?XE-------|-TE-B-MT-------o-----B----X---oo--BT-----Mo-----|-XoX---BoT-ToMT--X-?EE-?T--|--------------TET-|--??|--T--|o|-|-T|----E-?X-oo-T?E?--|B-----o---?----TE-EBEoM-o?------|---?B---TMf
----|T-To?-----------B--?-T--E-?---X---X--E-----XB-----Mo-------B----T--B--MEBX--T-B-----M|-M--EX-?---XM---X-------?-----B---M?-----B-------M-MBT---ET--------o|--B-M|----T--XM-X--oB----?B?-|o-B-E---?f
-M---TB-ET---------E-E---X-?--------EX-|-?|ETE?-----o---E-T----B-----M??Eo------M-----?-?------M---|---T|---BX----To?--B-E-E?|-o-BBTE|XE---X-B----|------oX|oT--o----|--E---o------------EM|BT---oT----f
---M--|--MX---M?---|??B---M?B-??X--X-|-M-B---T-------E-|-TX-?B--?-----EX-MT----Mo-----|oT-B---TT-?----T--X----B-|--oTE-?X?-o-----M-|----X?XM---|-X--EB--T--|--T---XX-|E---E-------B?--?---------T-o-EEBf
----EEM------T-E--BoT--|M-oM------EE--E-X---------?-----Eo--?--|----T-|-E?E-----M--T|-|---|-?-T-----o----|XM?--T---------MX---?-X?------E--------E-?-|-----BX--?---o-------?---?-B----E--?--|--|------of
----?-Mo-?-o-----?-T-oE---E--T-BB-----|?-|----E|-------------o?T---XB---|---------?--E-----M---T--------M-T|-oE-?B----E---M-T--B--|-----E-TM-M-------E-?X-oB-Bo--o-?-X|----M?X??TT--E-------|TEX---X-E-f
mXB?E---EE-------E--E-M-E--BX--?-----E-E-o-||M--|--M--MX---X------?-------E---T-E?-?X-B-o-E-----|-X-o-o--M-T--|-BBBXE-oB---B----|M--------|-M--|-BE-o--E---oTo---MoT-----BE--B----?M-T-X|-oB-|----BB-X-X
X---X-------X--X---------X--------------X--------------------XX---X--------------------------X--X----------X----X-----------------X-------X----------------X-----X-----------------X-------------------X
