-----------X---X---EM------X?---E--o-o-X-M-?---------B------------------o--B-----oE-E------B--M-----E---o----BB-o-----------B----------------o-------------?-------------------E?--X--X-----Mo----------
---o-----------B--M--------B-B--o---------M-----M-------------------------MM----B--E-----X-o-----o----------E------B--B---------------------X-?------X----o-oo-----o----X--M--o--E----?-----------E-----
----X--------------------------E---------------E-------------X-B------------------??---o---------M-------------B-?----------o--o------o-------?---------E-M-E-----BE--------o------X----XB--?-X--EEE----
--E-----?-----------------B-------EX---X----E----o-----?o--X---------M----X--------EM--o-E-------M---------E-E-----------M-----------MM-----------XB---------?----------XBM------M-------E------X-------
-----------------E-------X-X---------------------------X----------B---------B--E----o-X-----------M----------------------o-?---B------M---?-X------ME--------B---o----o----M-----XM------------?---o----
--------X---X--------------o-----------X---------o----B-?------B-----X----X-o------------o-------B---------o----?----------------------------B-------------?---o--o?-----B-----XB-?XX-------o--------B--
--X----E-----------B--X-B---?----o-----?o------------o-o--------------------------BB-M-------------------------B------o-----o--B----?-----------------M----B--------X-----------------?-----oE-------X--
-------------o--M-------?---o-B--------------------B------M--E-----X--?--B----X---?-M--o----E---?---------M-----M-------X----------M-----------------B------------------X--E-X----------E----B-?---?--?v
-B------M----------o-----X--?--------------B--M-??-----o--------o--B-----M-----------?------------E---X-------oE---o-----E--o-------X--B---BB-------------X--------------------B-----------X----X-E----f
-o-------------E----------------X-------?-------E-------X----------E-?-------E-E----E----X--------------M--------E----B--M-----B----------B------X-?-----o------X----o-----------------E-------X---X-?-f
------?-M------E---X---------o-----E-----o-----------o---------o---?-----?----------X----X-----E----------------------o---BB----------X----------------------X--?------X----------?-?-----------ME-----f
-------X---------B--o--------Mo-oX--------|-o----------------o---o--------------Mo-------M---o-M----E----------B--M--E?-M?--?------o--M----o-?--X------E----X---E-E-----X-B-E---X----------------------f
--o----X---oX-?-----M-o---X------X-------T-|TM-------EXE--T----EMBoT-X--?-----T-E---|To--B?----T----MX-BMB---o-E--TT----E-o-T-o----T---X??--T--??T---------------X-X---T---XT---X-XE?T--Bo-XB---M--ET-Mf
-T------T-----?--XTT------o-----Bo--X-?----M-----T--MX---T-|M---T-T-------?M-|T--E--Xo--EX---M--o-E-----X-?-T-T--X---TMTTo--T-TTo---B-o---TT-o---oB--T--X-o---T-M---EXo--T----BT-X-MX-|?E---o-----TET-Mf
m--XT-----X-X-?---X--E----EM?T-o-XoXXBTT-o--Xo|M-----X------M------M-X-oT--?B----------E-X?M---X--oB-BB-----|-----TEoMM-EE---MTM--T-X--BXB--X----------|X---M-T-----ET-M-To---Eo-o-EBX----B--------TT--X
XX-XXXXX-XXXX--XX-XXXXXXXXXXXXXXXX--XX--X-XX--XXXXXX-XXXXXXXX-XX-XXXXXXXX-XXXX-XXXXXXXXXXXXXXXXXXXXXXXXXX-XX-XX--XX-XXXXX-XXXXXX--XXXXXX--XXXX--XXXXXXXXXXX-X--XXXXXX-XXXXXXXX-XXXXX--XXXX-XXX-XX-X-XX-X
