--------------EM--------o-B---E------------------------MB-----------o---------oB--------M----------------o---------X---------E---------M-------X-MEX---EX---------M--------------------------?--?M------
--------E--B--o-XXo--------o--------E---E------------B---------------------o-------X--BX-------B--X---------------------o--------?----------------------o--M-o------M-X---o---------------o-----------?-
-o---------o----------X-M--E--MX?-------o-X---?-----X---o------o-------------------o-------?-----------o---E--B-----X-------M--------X-?----X--------------X--------X--X-o--B-------oX------------------
------------o---------o---?---B---------------o-X-o-----------o?--?---------------B---------X-----X----?--M-Bo-----------------------------------------E--------B-o---------o--M-----B--M----B----o-o?--
-----------------M----------------------E--------------?-o-?------------------------?-?-E--BX--------oB-------M-------------B----------------o---------?--------------------EX-------------M----o--M-o--
-B-------------------o-------BB-------------------XX--------------X-X----BX---X--M-o-------o----------------X-X---o-----------oo---XB----B---------------------Mo--X------o--------o--?------------?--X-
------X----------------E-B--------------MXBX--------X------M-----------o-----o?-B-B--M-----X-X---------?-----------B-----oo--------?--o---------Xo-----?-----------------------------------X------------
---o----X-B-----E---?----o----B----o----------o---------?-----------------------------BM------X---X---B-M--B--------------o-----------B---------E-M------------------?------------------o?-----X--?----v
---?--o---o----------E----------E-o-X------------X---B------------X--o----o------------?o--------o--------------------M--B----------XX--------------M--o---------------------o-------------------------f
--------B-------?-----------------XE----o--------------B---------X--B------o------?------------------E-o--------o------E-------------M-----B---------XB-----------X--X----------B------B---------------f
---------E-X------E---X-------B?-o-------E----X----B-----------------------------?-------------------XB---X-----E---------------?--M--?-------------E----X-------------E--B----------X-------M--M--X-B-f
----BoE--X-?B---oo--B--?--------X---------o-X---------o-B----o----------------------X-----o------E-------?o-X-----------------?-----------XB---------B------o-------X-------o-------o---------EE-------f
------TXT----B--X--X-----T-BX--?X---?-To--o---?XT-o-B--?-X-oo---?E-----oTM--T-----o-T--X-TTTT-To--TT-T------M?-T--X-?--o-o----MX--TE--o--X-B--BTT---?-M-X--o---o-o--?-----?T--T-o-o----TT----E-BT--M---f
-------E|--M---E-----E---|----X---EE----B--E--X--E------XX--||B?--T-----|--T|-----TB|---T-?|-T---E|--|---------|-----TEB?--E------TT--M-TM-?----|----------------?-T---TM--||-|--XM--T--|---M-M-----TE-f
m-----|||E-To------------E------B-T---ToE--|-T-B|--E--EE--T-||oE-------o|--||-----|B|-EB|-TT-|T|oT|--|Eo-------|T--o-|EE------oT--||-o-T|----?-E|--?--T-----T--XTX-|E---?--||B-oXT-BEo--|T--T--E-TT-|M-X
XXXXXX-XXXXXXXXXXX--XXXXX--XXXXXX-XXXXX-X--XX--XXXX-XXX-XXXXX-XXXX--XXXX-XXXXXXX-XXXXXXXXXXX--XXXXXXXXX-XXXXXXX--XXXXXXXX-XX--XXXXXXXXXXXXX-XXXXXX-X-X--XXXX-XXXXXXXXXXXX-XX---XX-XX-XXXXX-XXXXXXXX-XX-X
