-XTX-o-XoX--Xo?--?--X-B?-oX-X-XEoB--?XX-----TE--X-oB-T-B?-?BXET--?XoXo??B------oXBo--X-XX--X-o-M-??--B?oB?-o??X----BB-EBX--?XoX?B--MB-X?-E--o-o-o-B-oX-?B-XX-o|TB?--T-?---?|-B---M-?-EXo?o-??--?-?B-o---
-EoXBXX?-E-B---X--XXB-MMM?M-X----XXoM-?B?B---|-?-B-T---oX|-o-oo-XX-Xo-M-o?-|X?oTo?--?Xo-oXM-?X-B---?----?---o|o?MX-?BXB-M?B---X--oooBEMoEoXoXoM|--o-M-BXEMTX--?E-X|M?-??BX--?-MMX-M?o?MX??X-XBXE--?o-oX-
--X-o-EMBB-X-BE-B-BoB--?-MM--TBX-X?-E-X?X-X?-?--B|o-XoMB---o-E---oo-|o-?----M|Eo--BXE?EoB-Mo-E-Xo---o-XoMMM---B?-TXo-E-TBM--?--XXE--?o--??------XE-BoE??o-M--M---X-oo???M--XM--Xo-EX----BBMX-----XM---o-
---X?M---BX--XX?-MB?-M?o-?---Mo-??-?E-----X-XMXEX-oX----ooM-X-?o--EM-X--E??oo-oo-XX--?XME-TBXMBX??---|?-o---T-o-o--MX------Too-X?o-EX??---X--BME---M-oEo---oXE---M|??o---o---B-Xo-Xo-X--XoMB-E?-M?|X----
--o----?-oXE|--o-o-?---XXEX--oM-----TM--?o-oX?--Eo-XME-X-X??-o-XXXoMX--??XX?-ooBM?-E---?-X?ME-XoXTo-XXoEM-E--EX|-?--XB?MX--oX?--XXEMB---BTo---XX-BoX?T?--?X?-X-XBBX-EXX-|?-EXo-M--?M--o----BBXoM-|X-E---
--?o-MB?-?--X--XEMEXoE-?MXXXMoEoo---oX-ooMEBXo--MBXBBM?XE?----BX?o?-?Eoo-oo-|X--EX-oB-BEB?oX-?E?-o-XX--X-XB-|BMB--X--XXX--X-?o--o?XX--o?E-XXT-X--|?-?|?BM-X-Eo----o|XX----X|XB---X?--o--X-|-Bo-B?XXXo---
-?oX-B?-X-----?E--XX-X-X-X-XXXE-XXoBXB-oX|-E-?-X--Mo?M-BXoX-T-oBBXBo?Eo-E?---???B----X-X-B?-o-ooE----??TX?-oo?-BE-X--E-ooBMX---o?|X?--oXT--o-o-?X-?XEX--ooX-M?X?EB--o----ooXM--B--MMoo-E|-o---XEBX-X-|--
-X-M--?-?B--?-B?B-E-BTX?X---XX--M-E-X--oBXXoT----?BXo-E--?XooM---------oo?oo|-oXMT?-X?--|BMB-o?M--T-X?---EX?---oT-XMXo--oX?ME?o---XooXooE-M-X-B--M?-?--?-X--|?-BE-|M--B--o?B|-X?---??--oBE----B---?--o|v
-M--o?-B--oMXXM-B|o-XoEooXo--o-MXT---T-X??---M----MXoXoB---------o-----|o--X?X-M?XBX-o-E--M--B-M--?ToB?Xo?X-X--M--?----?-X?ooE--oo-XX-EX-X?B-X-o--E-?-?TX--X-E-Eo----M-MX--MM--B?MX--o--XM?-o-B--E--M--f
-E-?XX---BMBEM-----BE-X-oEX-ooE?o?X---X?-oBB-??-M-EE?|-?-o-X?Eo-XBB-o--o-B--|o--?B-------ooBo-XB?-?--B-TE-?oB--?BoEo--Xoo??-M-o-B-oX?B?----|M--XT-M--??-?MXo?-?XM-oBXo?--M---??-ooE--oXBX-BMX----o??---f
-------X-M--E--BB??-X?-oo--B---TToEX---B----X---X-MBBEB--|o--M-o?-oE-Bo---X???X-|-?-?--TBEo-T?--X??EX-|-?M--oo-M-XXXXooTE-oMB?-o?E-X-M?-B?--MBE?-XX----EBXBXBo---?XXo?-EB?To-T---Mo?---?-Mo-B--M-B--B-Xf
-----X?XBEXB-EX--E-o-B--oEX-M?--MM-EXX-E-X---?o|B-o-?|XBTX?--B-??X-XEXXBT-o?B?--ME?B??X-?TXTE??--X-EXBX-B-?oXXXo|?---EoX-o---BB--?T--BXE?--EM?M--E-|B?o----?MM|M-T?oX?E--B-X--E-E---B-M------?-XBBMXo-of
--o-X-o-X-XXoo-o?-?EoXX-o-MX-T?o?-M?oM-XooMBEE--X-X|o|X-E-?o---oB?ooTM?-BBB-X-B-EBM?X?TBX?ooMXB?M--XX-?--E-?o|?XB-TE-XMoBMMo--B-M-XMXoEXB-B-|E?BXoEoo-EB-BB-XE-E---EBT--B-X-XBooMEB--M-o?-?M-ooXMMo---Mf
--X-BXXMo-T-MoX?BE-B-?-M-BXXB-MMEoX-XMXBB-B-oX|-X?M-BTBM-X--?X-oX?XE-?o-BMEBXMo--o---o?o-??BMM?o-M-XBEo?M-M?M--E-M-XXX-XBX--MEE?oXM--?M?XBXoB?T|?XMM?X?-B?B?-T?-E--o-?X-MXB?BT-oX?oX--EX??BoBXMoX?X?EB?f
mM-EMEX?|?BBE---?M-MBMB-X?BBB--XoB----BM-Bo-EoMXXMoM-ooo-?-E?--oBT-E?X---?-X?--E-XM?B?-o?BMB?Bo-?-XXM-TBE-oXX-MB?B-X-TB?X---MMMXEX-??-?|BE-oME-BBM-B-TTB-o-?-BX?B-oXM|XBX-ME--TXM--oM?oBEBBBTE?|o-XB-o-X
X-XXXXXXXX-X-XXXXXXXXX-XX-XXXXX-X-XXXXXXXXXX-X-XX-X-XXXXXXXXXXXXXXXXX-XXXX-X-XXXXXXXXX-X-XXXXXXXXXXX-XX--XXX-XX--XXXX-XXXXXXXXXXXXXXXXXX-XX-XXXXXX---XXX--XXXXXXXXXXXX-XXXX-X---XXXXXX-XXXXXXXXXXX-XX--X
