----M-T---------M?-------B-Bo|--------?T--E--------MM----EM----------M|---o?---o-o-X-M--?----|--TX------------|--o-T------E--M---M--B|--M----M-|--B-E?--X-|-----M-E-E-|X-oBE---------o-?-E--X-------B---
-o----B-----BT-B-X--?|-X----o?B--X-B-----M------T-E---T--E-BT-T----M----------------M--X----B------X|-BX|X-------T--?-M----o-------BE--?-X-----M----X-----------X------|-T--XT--B----TT---|-B-o-|T------
-?---------|X--------------T----E-----------|B---B---E---T|-------o-------------?M-?---o-?--?-?o-B-o--E-----?----E--X------oE-oT?------MT-------X----------B--X-o-?M--------T--?--TX-------XT-----To----
--------------M-------------?M-----TTTM---oM-------M---B-|-M---T-T?---------T------E|-----?X-E-BE------X-o----?B------X-M-o-------?T-M--E-B-?M-----?o--T-MX-?-------------E-E-o--B-?o----------?--------
--|-------o----X----M--??|-|--M--B?--------------M------T---X---o---|-|X----?M--M-----|-|--X-----?T--|-----o-----|---|--------BBT-----T---B--M-M----T--------E---T-X--o-----o------X-------------?M--?--
--|o--o--?---XBTE--T----E-?--T---X---E----T--M------o----|-----XT--------o---------E---|o-|----X-------o----M--E-M-?----B|-oEM-X-T--M----------?-X-----T|------ME--T--T---------o-T-B-o--T--o-----------
--X--?-X--------X--------------|---MX----E---B-?-T--?------ME--|--M-?---------X-M-oX-EM---?-M-M-----X--M-B---o---E------T-----BB----B--M------T-------------M---------o----B----E---T-M---X---E-XXX--oo-
-------|----?-|-T--o-X-----o-----B-------------E--|--ooX--|----B-E--------E-X----?-?-o--B---E--E-----------------|----o?-----M-E-----?--T--?-T-o----------------XB--------T-X---T-M--X-----B--|-----o--v
---M--------E------XMM-----E-o------B------o----?|----X-T-E|---oB-M----E-----?------BM-----------o---------X-------EX-B--?E-----------|----o-?-TT---------|X--?-X--o------|-M--B------T---|--M-------E-f
---T--TE-------------X----o--E---B------------|-B--|-----MB-----X|------|X--o----M---?----T|----E----|---------T----X--B--E----BMEM--XM---TM------T?---?B---?X---|-?|?----B--M-------MB--E---E-X---M---f
--M?------?-----TMB-B-M-?E----E-M-E---T?---B-----E----B-E-XM--|---E----B--?---|M-------X--Bo|?-TE-----M-X-------T-BE-----------?--T--T---Eo-o--E---------B--o-B---M--o-------T-X-----X--o-?------oE----f
----T---?-M--B---T------T-----------M-B-o--X-----|X?--ooT?-----------X----T-M---?-----Bo---TE--X------E|X-X----B-|M---?--B--X-------------M---T|------E---M--?X-------?--XM------?------?-------M-E?---f
------E----T-------------M------?---M-----------------------------o-oo-----T-T----B-----o---?-T----M---o?-----o-----o----X-----o-|---o-X--E----M---T-o--X-?-MM--B|--T----|-B--EX----|E------XTB--------f
-o-oo---BT---?-T-----|-|---E---|----T----TX-X-o-----TX----E----------o-----------M-T------------------|---E------T--?--T------------?-----|--------X-----------o---o-?--oT--MB------------X---X---ET---f
m-T-|-------?-T|---M---Eo-E----T----------|--EM-|----M----ooo-o--o-TT---------M--M---?---?X|--E----|--------E-?o----------o------M-|MB-o-------------T--?|--------B----ME---BE------B----B-T---To-E--?BX
XXXXXXXXX-XXXXXXX-XXXXXXXXX--XXXXX--XXXXXXXXX-XX-XXXXXXXXXXXXXX-XX--XXXX-XXXXX-XXXX-XXXXX-XXXXX-XXX-XXXXXXXXXXXXX-XXXXXXXXXXXXXXXXXXX-XXX-XX-XXXXXXXXXXXXXX-XX-XXXXXXXXXXXXXX-X-XXXX-XX-XXXXXXXXXXXX-XXX
