-----E-o-?Xoo?--TM-B----?B?T?-?--oo?XE?MB?BX-XE?-X-XXBE-X-X-XMo?Bo?o--X-X-X-XXEMXEB-?-E?--E-o-?MXo-oM----o?X-X?-XM-||----o-?--oMMX---XX-?-XE?-M-M-XT-?Mo---?B---X?---?M--MBE-BM|XB-o--EEo----MBMB-E-E-X-
-XBXMB?XXXE-EB------EX-o-o-X--X----oBMX?M--X-??--M-?-?-?XEoBXB-?-E-|-X-?-?-MEM|----BTB-oo-o--B-?--oX-XXMB?|o--E-BM--?XT?-TXE---?XXo-Eo-M--?---X??-?|M-M---o--T-B-oEX-X-EB-X-X??|?--B-M--X-B-oX-oE--MXo--
-MXX-?-Bo-oX-TM-ET-M----?XXBM-M-o-oXB?-EM?XM-XoXo?--X-?oo|-XX-X-MTX-----o?X????-oXXE?-ooo-X-M-?o?E-----T?X----B?--?BB---MooE-oB-------XMX-MXB--X-MX?oo-B-X---T-oX?B--|?---?X--MB-B-|oE--X-?X-X?-M---|X--
-o-?-M-oX?-?-B?-M?-oM-EEX--X?--BBBoB-oXo?o-EE?B?--o-Boo-?XMo?-B-ooM-BM--X-------|o-To--o?T-X?---?--E-o?Eo?X---MB----?oBE--MEB--M-B--X?-XEME---oMB-E-M--o-X--?Mo-MX-M-?o--XXX-E-E--oXXo-Bo--XX-----M-oXo-
--oM?B-X-o-T--?BEBX??T?X?EE--o-?--?XBBo-X-o-M-E-?EB-X-B-EoXE---XoXBMMXXMB|-?E-X-??-BXMo?X---T?|o-B?oXo-MXMX--XE?-?oo-??o-B?-?|-XooXTE-oo-XoB---X?X-oX-|X?BX-??-XoE-E-X--B?X--?-X-E?-B--o-MXBB------?XB--
--T-TX--|-E?BX?-?XEM|o--XXMBBMXXTooM--M-EXoX--X?-X--B-X-BXMX-BBE--X|-X-XXX?-BoMX|EX-----oT-M-o?X|M?-XB?|Xo-?|?-----|-Bo-EXE-ooo--B?X??M-MoX-BM-oXoX-M----X-XB|X|-B--o?X-?BXE?BX-?---o-X?XX--MBooBE?BE---
--o--EoE-X-oM?XB----o??-XXXBoooM-EX-M?---X-M-o|E----X-o-|-XBBEMBXX-T?-B-?B--?XEX-oX-Xo--MoM----B?-B-|-o-??-E-E?X--MEB--BXXX?X-M-|-MBMMX--?E-X---MoBEo?-B??|?XXoBXBX---------o-E?EEB-X???XX----XB?M-??Mo-
---E--TX----?M?X-BoB?-oo-XX-E-|o-BM?E--|XXE?M---E?B-o?oooo-?B-?|?B-ooB-X-???-X--oB-??-BB-EoXX---?X-oBBE?-?-MoBT?--?XBXM??XBE-M-XXT--X-X?-?X?--B?|-EMX-o|MB-EM--TEB??--?-MoMBXo-XTB|--Bo-?-XXMX-??--ME-Mv
----Bo-ME-----X-?-XX|BM|B-E--oE--oB|o?EXoXX--Xo--Bo---o?--o---o??|oXEM-BXXX-?--?--E-EX--BEXoM-B-o--?o-o-----E-?-?B-?oM-BB--?-MX|?-X-X-?-E--XX|B-?-TX-?BX-E?X-oo-M-oX-?----?E?T?o-??----??oXoE-|----ooXBf
-EoMX-X-?|?XX|EM??Xooo?-|T--o??--oBXX?---T?-E-?--?|M-B--BEEB?X-MXM---Eo-?B--|-?MoB-ET-X-XEo?o-|-?-XXBXE-T-X?XX--X-MM--o-|o?-M?-E---o-E??-XB-----oE---?X--EX---oXX-XoM?ooo-?B?B--T--o---MBX-B----?B-?oXof
-oX-?--X--EB-Bo--X?MB-Xo-o--??XE--?|-XXMM-X-M?M-Moo-X|MX--?--E?BX-XM--TBXX-Xoo-MM??E-BX-oXX-?XX?----EX?o---XXoE--XMX-TX?-?--B--oo?-?B?M-M?-?-o-MB-|?BXBo-X-EE-?--E-?Mo???-oB??Xo-XT-X--oXX--oXEo-------f
-----o---E--E?oEMo-oMXo--?o-o-ME---X-XoBM-EX?--?ooo-|BB-?--X-M-E?T----BM-T--oE-oX?EX-oo--o-?B--XXoX----T-----MX?M?X-E--?XB-oEBoXE???-M?X--XE??ooXX?-?E?-X-o??EEo|BBo-oX-?---o-X-BM-----?EB-TXo-----?EXXf
-BEEXX?--XoB-oMooX-BE-Xo-|B?-XB---?XEooTo|BXXo-EB-?XXX---o-BoX--M-?-E-E-B?-oB|?B-oBo-M?--?oo-|XB?--?--|?oB?ooBo---EX-XXXo--B-----Mooo--?oMoXXB-?B-BXXo--B|B??BoEB-?|EXEoo--BB-BEXBME-ME--B-XXEMXBoEX-MBf
-EMBM?oEE-oX??XoX-E-o--MXM?---To-X--B-?MBBoB-Bo-M?o---Eo?oooM-M-BX|X-o-BXB--MoMEoMXMXo??MoEMBo-o---X-BB-?o?Eo--oEEXBBB--B-XoMo?XXB--MXo-o--Bo-oBT-BEB-B----B|---BB?-oo---BBo?-B?M-T??BBBXMBBX|XT-XB--?Xf
mEXX-XE--ooMB-??---?X-?B-X-Xo---BoET--o---ooEB-X--X----X-B-E?-??B-Eo|MX--oXE?oBXBMX----B-E--BXB-MB-E?M?XB---XXoXBXooXoMBBo--oXoM?-M?TB-M---X-X-XM?-B--oX---o--BB?-oBBEX?o--?MoooX--oB-?o?-XXB-MMXXX-oXMX
XXXXXXXXXXXX-XXXX-XX---X--XXXXX-XXXXXXXXXXXX--X-XXXXXX--XX-X-X--X-XXXXXXX--XXXXXX--XX---XXXXXXXXXXXXXXXXXXXXXXX-XXXXXX-XXXXX--XXXXX-XX--XX-XXXXXXXXXXXX-XXXXXXXXXXXXXXX----XXXXXXX-XXXXXXX-X-XXXXXX---XX
