-------?-------------XX---X---------------------------B--------------------B----o-----B---------E---------MXX--o-----Moo?----------B-------X----E----X---------------------B--o----XB-------------------
-------EB-----------------?-E---------------------X---o--------?-------o--E---?-----------?--X-------E-------X-------E----B-B--X---------X-?---------------------B------?-----------X---E-----XX--------
------E---------------------------------B------o-----------X--?---M-----oM----o-----?-----------------------E--E-----E-------------X?---?Xo-oo--------B-----M---------------------XXo----o---------X--o-
-?----E--X--------------------------X---E---E------X-----------------------------------------------B--oX------------M----E----------------oo-E---------o-o-B----------XB-------B--oX--------------?-M---
---o-----Bo-o--?-----ooM--------------------B----?--XM-M----------?---o---------Eo--E-o-----------?-----B-o------------??-E?----o---MX-----o-----B-?X---o--------------------------------X----X-------M-
--B--E---------o-o---X-?-B----o-o--BX-----o---?--M--E----B------------o---------------?--o------B---------X----------o---X-X------------?-------------B--M------------X---------------X--o--M---B-?B----
-B-X---------o-----o----X----------?--------------o-------B---oX-------------MX--o--X-----------------?--------------------------B-?----------X--o------M--------------M-----------M--oo-------o?-------
--o-----X----o-?--X-o-----------M-------------------E--------------M-----------?--EX--o--E-Xo-------------------------------------X-X----X-----------?-----Bo--------E--------------E----Xo-ooX------X-v
-------------------------------------------o-------------M-?---------X-------------X------?---o---B-----XM-----E-----X-E-----------------X----X-B----o---------B----X-M----------------------E---------f
-------?--X--------X----X------oE---o----B-M------X---M-----o----?o----?---XB-------E---?--o-----------------------------------X--------oE----------B-----?-----M-------E-------------------B----------f
-----E-------?-------------------------B---E-------------------?--M---------------o------??----M-------M-------------------?--------------X--E--X-----B--------------------E----E-?X---E--M-M--?-X-X---f
-----o---X--B---E----------------------o---o-E------------XM------------??----------oX----o-?----------oX----X------------o--------B---o-----?--------------------?----------B----?----EE-o-------M----f
-EB-------M-----o-o----MB-o-X-B----X---M|-o-----T-M--o--o------o---B-E--XE--MM-?--X---ET--T-------BT-T-----X-T---T-|--?-?X-----TTM-E-?--T-TT----X---oo---TX--E-BB-T----------|-----T-TX-TTX-?-XoTB--M--f
------X?X-XT-T-B------T------------X-BTME---T-B--BT--BT-----TX|--?---T-o---|-T--oTXB---------------T-B--M--T--Xo---EE---?---BT-B-----T-B--B-|-?---M-o---TB-oB--M--X-?T--ToB--o?--------T------X-X-M-TT-f
m----o--T?--T--------B-X-oE-TTT----E-TE-X------o-X-B--E---M--o-Eo?---------X-M-?-----T--X---T--?--|-----T-|----B-T--M--o-?T-M--|o---T--------T--XT?o--?-T---------o-T-TX-E----T-----?TMTT-----------B|-X
X-XXXXX-X---X-XXXXXX-XXXXX-XXXXXXXX-XX-XX-XXXXX-XXXX-XXXXX-XX-XXXXXX-XXXXXXXXXXXX-XXXX-XXXXX-XXXXX----XXXXXX-XXXXX-XXXXXXXXX-XXXXXXXXX-XXXXXXXXXXXXXXXXXX--XXX---XXXXXX-X-XXXXXXXXXXXX-X--XXX-XX--X-XXXX
