-?---MB-----?---B|--TM----------MT----X-----?B----XMoM-|o-?M----B---TEo?-X--XM?-T---------BXE---M--MM?oo--ME-?-T-E--MXX-|-|?|--XX-B?-oM--E---|----------o----M-?-B-----BTT---|T-X-X---BE-X-----|E?--EX--
--ETT---MME--M-BoXo-XX----X-----|-ooT-EX---E---M---X------|--|----T--------M?o--B?-|B-X----E---|B--E?--TEME------|ET-?-----o---|-X----|oM-------EE-M-T--B|-E----|EX-M-E|o-------ETEBB--X?X----M-oX-oT---
----Bo-o----X-T----E-----E--T-----XB--o--E-M----EB-M----B--MXB-X--X---?------XT---X-|B--------B---------TM--------E---E------XT-XM--B--E?o-oM-----EB--E-----BM---o----T----?Eo?-----o----E--M-EB-o-X----
----|----B-----|TXB-----X----M-X---T-----M?---?--Bo------|--M-MEE---M--|------MM--?-o-----|-TE---M---XE---Eo-E--X-B----o|-----oooE--M-----oM-?XTB-------M-BM-oo--EX-?B-M-|-?--E--B--oEM-M--B?-B-TT--E---
---T---XX-o-ooo----T------?---M||---?-TM----X-----------T---?XM-MMM---?E-----M----X---T-M-T-E--M----o--------E--o------MB-TB-----TEE-B------MoBo----ET---?-X?T-------X---X----X--E----X---Xo?---X|------
---X-Eo-T-M-B-TX|TM--------?-B---|-E---T--o-----EXo?--o----------|----X||M--|---Bo---------|--------oB-----B-----XBM-T----M-------?-----T|-|??-XE-----?E--|--XE----ME------M?----T---E-X-------E------o-
-------------X---E--o-|---X---?--XT?--|?--E---------M--X-T---M|-T----MM---X-----|-|------E-----M--?-||T-o----T-?---XX--T----o-|------EB----o--?--M-----B----?-M-T-?-----?---M--------o-XE---oB-?---?--T-
-X-----------X--X---E--X---BT---E-T-|o--X---------MBMBB|-----XTEo|--E----------M-E-T--o--o|-M------EMEM-B-T-B-|-o--?o-T--B?-EX--M-|X-?-X|---E-X--X|EEM---T-E-oT?-T---B|----?-X--E---|---?-----?E---TM--v
-o-MB-BX--?---MM-XM-B-------X----B---?--TT--X---Eo-X--XM-X-B-----B----TM-BXE---M-----MEB-------T---E----?----B-------o-|X-oM--------o-|BX---M|TTM-------Xo--oB-------M--T-?|o----E----BX--------B----BXf
--M----------BB---X----M?E-?B----o-M--o?----T|-|-?-E--B-T|--M|o-o-----||-----?BXBE-oBE--oB-T?-------B---oBX--?|-----------o|ooT-----?-M----X----E---|B-BTM-M---MM--B----B-M-X-M-B-T-|X---|--------B-o--f
-o--T|----------------B---T---X--M--X-TE---MoX-MEo-E-?--o----X|M-------B--M-----EX-------------TB------EM-|-BMo------TXXXT-|M---X|oB-o----|----M---|-M----o------X--?--E--?---M-EX--|X?-?X--M-T-TB---?-f
-o-B----T--TE---X-o--|X--ToB-X--o----M-|--E------T-------X------oTXE-------E--X-BB--XTMB---?EB|-E-E-X------M-o-----E---?---?--M----E---MM-o---B-o-|----?--?-M--|-?-B---M----E-|----------oB-----T-|o--Tf
-E-T?---E---o--EMT--T---T---X----EoB|TM?X?T----o---B--BBo?MM-----?---M--?T---E-B----|----E--o--o---o----MM------E---------M-----|----B|--oM----|M-----X?T--E-T----M--|--M|---B--MM|-?-----------Bo-MT-?f
-X---X-|-------?E-o--------------M---B-?--XT-----Xo-----B|---o----TB----M--|-B-?E---M--B-o-?M--X--?BEM-o-X|M-B-X--?---T--E-o-MXB-|E-M--|?-M--T?---X------?-E|-M-B------o-----T-X-E-??M-?-----X-------Tof
mo--X---MM-?M----X-E--T-MM--B--?----?-oT-----?-T----EB-T---ME-MTToo--------M--o?ToE----MXE?-ME----?|--B---?----X------M---B--MM--B-E-----T--E------X---?---|-----------|----B------?-----------M|--?---X
XXXXXXXXXXXXXXXXXXXXXXXXXXXXXXXXXXXXXXXXXXXXXXXXXXXXXXXXXXXXXXXXXXXXXXXXXXXXXXXXXXXXXXXXXXXXXXXXXXXXXXXXXXXXXXXXXXXXXXXXXXXXXXXXXXXXXXXXXXXXXXXXXXXXXXXXXXXXXXXXXXXXXXXXXXXXXXXXXXXXXXXXXXXXXXXXXXXXXXXX
