-----?--o--X--------B------B-----?X-----?X-----B--E---M-?--------B---X---B--------------?--------o----o-----oo-M-----B-BM-------------------o--B----E--------B-----X-E------X?--?-B----------o------X-M-
----?--o------------?----------oE?----o-----------o----------X--o--------------------------------o---------?---------B---------------E?-----------------------o-----E------------------o------------o-X-
--?---BX----X----B--B--------------?--?---------------X--------------X------BB----------------B---------------X--o-----X-----E?--B-B-----o----o------------B---------?--?---?-------------o-----------B-
--?-o-------------------M-o--------------------------?------?-------------B------------------X-----?-------------B---X----------------------X--?----------B--------o----X---o---------------?---o-------
-----M-----------?-----E-o---o-----------------------X--X----------o----------------M--------o---------BE-----MB-?X-----XM----------M?M----------?-------M-----------------------------?---X----?-------
------------X------------E-------------X-o--------------?----o-------??--M-----------?--?-X-B--B--o----B------X-B---?--M---?------------------------------------Mo--------------o------------------MX---
----Bo--------M-----B------B---------X-----?E------B-----M---M------oM-E------o---------o-------------X----X-?--o---X------oXo----E--E----Xo---?---------------------------------?----------------------
---------------B---EBX-----o---X-----E-------X----E--------------o-o----?----X-----M-------o---E--------E-?-?----------------------?------B-M----?B---------o--B-----------------M----BX---------------v
-------o------X------o----oE------------------B-oB------------------------------------E------X----------------o---XXX------------------B-MM-------?-------?--------X-----XE--------------X-------------f
-o----X---E-?-o---------E---------------B---o---------M--XB---o---EE-B?-X--------------X-----X--B-------------B-----B-------o----M---------X------o----o-----BX-----o---M--------X-----------------?-X-f
----------X---B---o---------?--------o-E--------B-?---M--------M------o-----X----------E--o----------B--------B---------------o--------?------o------M-----E-E---?---M--------?-E-o------E-----B------of
-------o--?----------------X----------o----------------------B-------X-------o---?-----------E---E----------X----------B-------B----------o----E--BB-------------BB----o-----??---B---------M--B-------f
------B--o-X--Bo-----?-E---?-X?--E--BM-EEB----oT-E---T--MTX---T-?-----?-T----X-T-XT-E---M-TE-----o----Eo------E-X-----BT-X-----EX---T?TX--X-o?--X-TT?----EEo-B--X----T-----T---BoooM-----T--?-M---X-XE-f
------B-T-X--B|---M---?------------------E-B---|-o---|-E-|-M--|----?-Xo-|-E----|--|-------|-----E-----X-----MoE-E-----?|--T---------|-|E--------oE||---Mo-X------E---||---E|o--?-----X---|-BE---EBB---Tf
m-------|----||E-?-----E-X?-o---o--------T--E-E|---E|--M-|---X--X----TT-|T---TT|-X|Xo----o|--XT--BEM-----?-----o|--E---|---T-o-EE|X-|-|---------Eo||-E-T--------M-o-o||--E-|-X--B----T---||-E-o----|--|X
XXXXXX-XXXX-XXXXXXXXXXXXXXXXX-XX-X-XXXXX-XXXXXXX-X-XXXXXXX-XXX-XXXX--XX--XXXX-XXXX-X-XXXXXX-XXXXXX-XXXXXXXXXXXXXXX-X-XX--X-XXXXX---XXX-XXXXXXXX-X---XXXXXXXXX-XXXX--XXXXXXXXX-XXXXXX-XXXXXXX-XXXXXX-XX-X
