-------M-------B----?------o?B-------------B-----B------oX--E------?--------------E---o--------oXE--------X-B-----------------B--E--oB----------------------B-----------oX------o----------X-o--BMo-----
------X-----X-----BEo----------------------------o--M------------------------------------o--------------------B------------------M---------------X-BX---B---B--X----X---------B-----o----------B--------
------o---M--------X-B--------------------E------------E--M-----------M-----B---X---------XE------------?-----------------X---E------oB-M-o?-o-M---------------o--X----------X---?---------o--------E---
-------------------o-----M-XM--M-----------X-----------------?------o-?-----o-----------B---o---o---M--X--B---?---------X-------o--o-----------B-X-------oo----?-------B?X----------B--E--?-------------
--M--------------------B-------B----E-M----X------------?---o----E----o---------o------------XBX--------------E-----X--------X-o---o--------------------o--o?---o------------?----X------------------E--
----------o--E-----M----------------------Bo---B------?o-------------------------oE------X-B--B-----X------o----E---B---X-Xo--E------o----o---------?-----X----------M---X--------M-----?E--o---E-------
--M-----X-----BM----------B-----------------o-----B-------------M--B--X------B---o--X-----o?----X---------------------M--------o-X--o--X---B------B--------------X-------------XE-X----------?--X---M---
-B---B---?------E---X----?-----?o--X---o---M--X-----o---------X----X-?--------Xo-?-----X---------E--------------X-----------------------------------o--B-o-------?-o---o------------E-?----------X-B-XEv
-?---------Eo----------oo---------X-o-----X----X---M-B------------o------------------------B---?EoE--M?-----o------------o------o---M---------------B--E-B-----X-B-------X------------E----------------f
-----------------?----------------------------------------X--------------------B-----o--X----------------------XX------------??-----------------B----------o-E--X--X-B---?-------?E-B-------o---X------f
---?------------o----o-------------XM-----B--?---?-?--?------------------------?--------------------?----B----X--X---B---------X-------MBM-----------------o----o---------------o-------B------------E-f
----------B--o--X-X-B---------------?-------------o-----B--------------?--M--o-X----X-----o---M---------------E----E-----------------E-o--------?----------------X----oo----B----?---E------------X----f
-------o?---B-X-ooTo-oT---oE-o-Mo---X--?M-ET--------XT-----MT-?--T------T----EB--B---BT-?XE-BX-----X-o--T-XT-B---M--T-o-TX------T?o-----ET--?BX--T--?T---T--BB-oo--------MEXT---XTo?---------E--T--T--Tf
--------E---E---M-|---|T-|-------X-----o-E-|---ET----|-oX-o-|-T-E---T-?-T?--M--------E|--|M------|-E?T--|--|M-------X---|--E----|----T--T|---T---|--T|||-|---T-----BT----T----?-E|-|--B-------?-|--|X-|f
m------To--M----B?|---|TT|Too------E----o?B----T--oT-|T-------|-E---|---|-T-o-M|------|--|T----oE--o-|--|-T|T------XTE-?---|E-E-|----|--E-BB?----|---|||-E---B-?----|-E-oB----X--|-|?-M-------?-X--|--|X
XXXXXXXXXXXXXXXXXXXXXXXXXXXXXXXXXXX-XXX-XXXX--XXXX-XXXXXXXX-XXXXXXXXXXXXXXX-XXXXXXX-XX-X-XX-XXXXX-XXXXX--XX-X-XXXXX-XX-XX--XXX-X-X--XXX--X-XXXXXXXX----X-XXXXXX-XXXXXXXXXXXXXX-XXX--XXXXXXXX-X-XXXX--XXX
