------X--?--------------------X--o--------------------Mo--------------E----o------------o----------X---------X-----?------B-----M----------------B-------E-X-B------------o--B---M----X-M---------------
------B--E-------------B---?--o--X---MX---B------------o-Mo-----E-----o-X--------------M-------------o---------B-----?--B----------------------XB----o------o-----?------------EX-------XX----B---------
----EX------------?-----E--o--------------------o?----------B-------?----------o-?--------o----X---X--?--E--B-----------o--X-----B---------------------------E----X--X-------M----------?---------------
--------------X-------?-------?---------------X------------X--------------o--o----------------o-----------------------o--------E----?----------B-----------o-Mo-----------------?------E--------B----oX-
------------------------------o---------------B--B-----?---------o------------------X----------o-------X--------------------B--X-------B-X---------X-----M--------------M---------B------E--------------
--------------------------------------E--o-----M----B---B-------X----o-----------------------B-------------------------?--o-B---EX----------?--------B------M-?------E---------X-----------M-X----------
------------------?-----o------------------------?o---o--E-M----------------o----------B------------?-----------E-----E-?---------------------------------------------------?---o--o----------X-------M-
---M------------?----------------XE------o----------X-------B--?------------------X----Xo-E----------------------------------------------------X------------------M-BBE-----------o-----------?--?-----v
-o-------o--o-M-------X---------------E---------o-------o-----------------X----o--------------B--X--X---------X-------X--------o-----------X---E------E---------o---------?---------X-----??---BB-X----f
-------------o----o----------B----E----------------o----------?--B-------------X-X----X---------------------------------?----o--o-X-------X--------------------M---?B----X-B--B-----o----------------B-f
-------?-E----------------M?----E-------------------------B-E--o------------------------o-----M---------------X--------M-----------------o------------?------------?-------?---------------------------f
--E----E---o--M--------------M--------------B----BX-X---------XXX--B---B--o------------B-----------------------------B------MM---------E---E----------M---------M-----X-----------------X----M----X----f
-----------?--Bo--B--?-?o--X--X----o-X-X-?oBM-EE---X?--X-o--X-?E------B----E-X-B-BM-M-----X--X-----X-?---M-B--o---------X--?----?M--------X-----E----------oo---E---BE----B-B--------------o--X---o-M-Bf
--------E------TT-------B---------T-o--?--------E----E-?TE--o------o--T---M-X-------T-E---o----E-----o---X--M-o------BE-B----E---------E-E-T-----XT-X----o------T--------------T--T-X----------T-E-----f
m-------o------||---BX----?--E----|--EE------oE---------|--------T-B--|----TT-----E-|-B-----------EE---E-E--M-?--------E---TE-----?-------T||E-X--|B--TT-X--E---|-X-T-------T--|-------B------E|T---B--X
XXXXXXXXX--XXXXXX-X-XXXXX-XXXXX-XX-XXXXX-XXXXXXXXXXXXXXXXXXXXXX-XXXXXXX-XXXXXX-X-XX-X-XXXXX-XX-XXXXXXXXXXX-XXXXXXX---XXXX--XXXXX--X-X--X-XXX-XXXXXXXXXXX---XXXXXXXXXXXXXXXXXXXXXXXXXXXXXXXXX-XXXXXX-XX-X
