--------o-M----|---E?-|----?--|----oB?B--|----|o-|?-|T-|--T-------o---T|----M--ToM-------M?-----T--??-BB-T---o---------B--?o--M-XoX-B-------M------Bo--E---E--B-B-oM?---|--XM--o?E----?-M----|?--?-?----
------o-X-------M--|---?------M---?--TT---BM---X-|-T--------?E-X-B-----TX-?-oB------o--E?TT-?-oMTX?---?--M---M-M---|M--?-M----------?|X?---E-M-|-?-X--T-----o?--------TX?---o---M-B---M|--B-|-EE------XE
-E--E-B-B---T---E-XETM-E-B-TE|-B-o?M--E-X---?||--?-----|-|T---oo--E-M-?----B-----|---B|--|-|----E-|M-----oB---E-M-?--T--B-T-o--EE----E--B--?--o?--B-XM|-|EBMoB|--|-o?E----E----|EM--||---oM----M|-|o----
----X-------M?----|-T-?---T--X----?-o---XB--M--T----|--B--E--o-----oXE-X---EME---|X-----X--X-B------M---|B-M-X-----|--|----------|-EMo||-----T---E--------o-M-B--|X-M-?----|------E-E-|---M---M------XB-
----EBT-?E-E---EETX?E-|-------M-o---B---|---B--E---XET?-----|-BB--T---o-o----B|-oX---o-------M--T-|?X------B----X----B--------MXB-E-?M---X----?---o-|----------?T----E---o--------B-|?M----X-XTM--o--o--
-TB-----?-M|--B---X----B-T------M-T---------------TB---?----BT-o--|--E---XEo-B-|--Bo-T---|--o---o?-BE-?--E----?-To-|-E|-M---o--|o-XTB-MMo--BB??TB--TX---B-B-B?|--X--o--------T-----T---E?o--B--?--B----E
--E-----E-----T-E-----E-T-?-T--TX--E|-?-----T-o?X-|-?|-|TX-XB-BoB-----To---o--BT--?B---E---?-B--?-?--|?EB-B--o--B--MT-o-o----X--oB-------E---------o---X----o|----XX---B-o?--T|XT--M--?-XMM-----M---|-M-
----TB-?-B---|-o--|-B-oT--M------o-----T------MT------?M----B-E---?---Bo--oTB--X-----T-|o----|-?-oT-M--o----?----E---E--------B-|METo-E|XBT--M----oT?--XM-TXT---TT--|---T---||-T-oM-E-----XM-XMo-----E--
-M-BB-|-----?--?----EE--------E----?T--X-TX--M--Bo--o-M---?-oE-M-o?-----|-M----XBTB-T--------XT-o?-----oT-MB----MX--?-M-M---------o---B----------?B--E---B---M--??X?T----------M-B---B---|-----BX--|----
-T-----|--M--M-X----X?----E------M---M?---oBT---E-B-B--T-T-?----M-E|X?E|----M-X-o-T-T|-|-?T---E-o--o-XE-----o------?M--BMME-T--oX-E-----o-E-X--o-B----B-oB--?--T-|?--M-?---X---o|M-E----X-o------|?--X|-
---T---B-?T----?----B-BT----oM--B-----?--?-TXo-T-----B------E-X------To-X-o-?-EM----B-B-o--B--o?--T-X-------To-E--E|MXXMB--B-|?------X--?X--MM--B------------BEo-|---E-----T-B----B-------Eo--XE---M----
-?T-BE----X?--M-----?B---XT---?oB----T-XB-----T?--|?X-MXB--E-|----E--T--Bo-------TM--E--EB-T-MX----T---EE-X---M-|---E?-----|B-TE-B--|M-o-ET-----M--T--|---?-----?--o--XBM|TXo?|--B-T|-MBE--TET-EM|---oB-
--T-M----MT-------|-X-----B--E|----------BB-oX|-----------o|M?-----Eo---o--E--M?--T-E---X----o-o--T--|----T--E-o-----XXT-M---oM-M--oX----|-oEo-T-BoE-BT-X---E-B--|o-----M-------M-X----|-T-B----E-M?-o--
-E--T-E--E------X------o---X-------T-B----o---TB----T-TTo--XX--X---E--??-MM----B---E-o-------EEo-B|oX--X|---------o--?-E-X----M-M-B--||M-E-E---E---|-X---|-?-EB--o---B---E--XB--X---oX--?--X--Mo----?-M-
---?-EB-M---?-----MXEM----oX------M?----o--E-E--?-----E--M?-?-?M--||-X--T-|--EE------?-TE-?---------Mo------B--M-----?E|B--ETE--|o-----?-MEM----T-?---M---o--o-B---X----X----?-----B|EB-?--T--|-T-------
-XXXXXXXXXXXXXXXXXXXXXXXXXXXXXXXXXXXXXXXXXXXXXXXXXXXXXXXXXXXXXXXXXXXXXXXXXXXXXXXXXXXXXXXXXXXXXXXXXXXXXXXXXXXXXXXXXXXXXXXXXXXXXXXXXXXXXXXXXXXXXXXXXXXXXXXXXXXXXXXXXXXXXXXXXXXXXXXXXXXXXXXXXXXXXXXXXXXXXX-
