--B------------------B---o-------B----o----E--------o----?--------M--o------------E----------------X-------?MM-o------------?oX-----------------------o-----E----X------o---------?-X-?--X--------oE----
---------X------B-----X--------?-----------------B-o-----------------------B-----?-o----------------------o-E-o---------E---B--------------------X-------E----oM----------------B---------Mo?-o-----B---
-M------------------X----?-----o---?------oo----------E-o------M--------------?---?-----------B-----------X-------------------B-----o-X--EX-------------B-o-----XX-------------------B-----Eo?M---------
------o-?----X-?---?-?-?--oB----o------?-------------M--------B------------------o-?X--o----XX---o?-B-Eo-B-------------o----M-------------------M----X----BB-----?-----o----M-----o-----B---------------
--------------X------X----oB----------M---------------X--MB---------B-----------B--------------E---B-------?--------------MXo-----------o--o------------------E-o-----------oo---M---M-----------o------
---?---B------------o-----------?--X----------------------------ME-----------------B-----Xo---------B-----X--------------X----------?---X-X-E--------M-o--------?----X---XXo----------------------------
-------------B--X----------------------------------XX----M-------------X--o------?o-?---------M----X----------------------------E-M-----------?----o-?--------?----------o-M---------M-------EE---------
---------B?--------------------B-------B---------B----------B--------Xo--X-----o-M-B--E------XB-------oM--------------------------o------------o-E--------o--------o----------------B------------------v
---------B--------E-----B---------------M----B------X----------X------------X------o-B--B------M--------------B-E-----------------------------B---------------------------------------?------o----?--o-f
-----o----E?------M------------o------E-----------oo-----B---------B------------X------------Xo------------?------M----------X----oo-------X-?---E-----o------o---X----------------B---oM-MX------E----f
--Mo------o-----------E--------B-Mo---M-X------E---X--M------o---------------E--------X------------BX----XM-------X------------------M----B--Xoo----------E-X---o--E-------X----------X--o--------o-X--f
--------------EB-----------------Eo-----?---X-o------o----------M-E-----------------?---X-----E----X---M?--X-E-M----?-----M?-------E-X-o--o------B-------B---------------X------?--E--M?--o--M---ME--?-f
----------M------E---?-T-TX----X-------o------TT----ToT--EBB---B-B----M?-ToTT----X--X---T------oX-?TXB----M----X---B---E-----XX-------?o------TM----X----------oX--?TT----BTB?-T-----o-----T--o-o-o---Xf
-------|--TM-----------|-||------o------XE-BX--|M|--|-|E---E-XoB--EX----X|B||--E-T-M--E--?-----EB--|X-----T---o---T-----E-|--T---------TE-B-|-|M?-?--?o---B----oMT--||?--E-|T--|ET--T-----X|--T----|--Ef
m------|--|B-------XE--|-||B----TME--T-M-?---Xo|---?---ToB--o----E-BE--EE||||----|--------B----E---|----EE|B---oB-|XX-B|E--?-|--T---MBX--X|-|---Bo-----?--o----T-o--||-----||--|-|B---TET--|-|X-E?-|---X
X-XXX--XX-XXXXXX-XXXXXX---XXXXXXXX-X-XXXXXX-XXXXXXXX-X-XXX-XXXX-X-XXXXX-XXXXXXXX-X--XXXXXXXXX--XXXX-X---X-XXX--XXX-XX-XXX-XXXXX--XXXXX-XX-XXXXXXXXXX-XXXX-XXXXXXXXXX-XXXXX--XXXXXX-XXXXXXXXXXXXX-X-XXX-X
