-----E------M-XT-oT-B--o-----T---------------------X---------------|------------------|------------T-----------o-------T-----T---|o-------------|--EE----EX-o------XoET--oT-------E--M--TX--B-------T---
---X-X-----X----B-----TXM-?X--|----|-B------?-----------TB----?o----------T-o-|------|-E----------?--------M---B-M-X--X---------T-?----|----------T-----?----M--ToX|------M--BTT-|---------X------------
-----o-M-B?--?EE-T-T-T----------X---------?-----o-o------T-o----------M-------TTT-----B?---?----BB-?X--T----?--------o--?--o-T----M-o---M--TE-o-T-?----------T--------X-T----B-oE----T--||-----X--------
---------------X-----------T-------------T------ET--T---------------T----M--|--------T-----------------X-B--o-X---------------B--T---------------------------X--TT----o---M-?------------------X-----|X-
--E------M---o--o--B--o------E-----|---o---B--------T------T---ToX------B---BX---o------T-----|-----T-o---o-MMo|-------o---|--T-------T--------B----|--T----X--------o----------------XT-----TTX--------
---T------B----T-T--------E-----X-X----X---X?----|o----------XT----X---------------X-MM------------oT--------T-------B---------B----|T-----T---------------------T-T--M-----T----------------|X------o--
---|-------?-------------o-T----|--o-------T---------------?-------o----T-------T-o------o--B-M-?-----X----T--EE-----XE----B------M-----B-----------X-----------oB------?--X----o-------T------X?-----o-
-----------------------T-----?B--X--------B----------To--T-T-----------B-?----X----o---------X--------B-MT-----X-T---T--E---E---T--o------------T------o--M-----o---M---------B----M----T-----MT-----|ov
---o----------------|o-BT-o--B----M------------T-M---------o----M----X--ooo-----------o-T-------?-X-X--o--------X-----------?--B-----?-o------------------?--X--T-|-X----------------B--E--T-----------f
--o-B---?-XM------------T---M-----T-T------X---T---------------------TTM--B--------?-------B-o---------T----X-T-----XoX--------M-----------TB----------------T------T---B-------o-------?--?E----------f
--M-------o--o--o--E--E-o----B--T-o-o--------??E-----X---------X------------oo---X-----XT-----T---|T-o--?T----X|-o------------T----o--?------------T--o-?-----T-------------TM-X-T-|---------X---------f
--------T---------|X-----T--o-----X---T-?----T-----M------------X-?----T-----------|--To-T-o----?-----o--X--ET--M-------X--BB----------T-o---|-----TT---M------XX---------o------X---ET---o----?o------f
---B-X---?-E---TB--X------X------?------?--ME--X-ooE---XE---oX--o----BXT-T------T-------------TXX---T----T-T-T-oBM-T---oMTo?XoTT--T----|X-?-T-----T|-X-o-o------X---------MM-oT---T----------X--T-T--o-f
-----EToT-oBo|-----T--o-------T--------E-------o-T--T?oX----B-?---E--T-BT-XXB--|E--TB--M--EEBo-----|-M-?-|-?--M---B-----TT--o-oXTMoT-MMTX--BooT--TETT------T-?oTMXo--o?----X-Mo--BT-X-|T-----MT-T----XTf
m-E-BE---B-----B-X?TX--M-|-E----TT-o-B----o---T-------?oo-Bo-X-----X?--o--MToT--Xo-T--T|B-?-oB-X-X---E-X------E-T--T-XMT-T--E--oT---E--T---ooM--T-T-|T-T-?E--TooXT?--X--BX-T?M--TT-T--BT------o---MX|--X
XXXXXXXXX-XX-XXXXXXXXXXXXX-XXXXX-XXXXXXXXXXXXXXX-XXXX-XXXXXXXXXXXXX-X-XXXXXX-XXX-X-XXXXXXX-XXXXX--XXXXXXXXX--XXXX-XXX--XXXXXX-XXXXXXXXXXXXXXXXX-XXXXXXXXXXXXXXXXXXXXXX-X--XXXX-XXXXXXXX---XXXXXXXXXXXX-X
