-??-X?--BEM---Bo?oBoB--Bo-o-?EMXTM-X-|X-T-T|X-o--|T|?|-o-TE?To-?Eo-M-?--?ET---|X-o--||T|---Eo?-o-Xo-----B---Xo?ToTTM?oMT-BX?T-M?-TBT-TX-o-oMXTB-MTTo-TX--X-|?oB?XXX--MEE---X?-XMX-X-T-EBXXX-o---XX?-T---
--M|T--X--X-ToTM--TT?-B-|-TB-X|---Mo??-?--oTM-?-M-BX-oTBBo?-XX-TXM?BXEMXXBBT?|TT-X-?XXoTTM--oX-XTBTXXoX-TBB?oMoo?-TBTTT-TT-BT---To-TXTM----XTo|--M--EM-T|--XT----XTT-X?oTXT?o?--o--o-oTBoM-XE-T-|BTBTEB-
-oEE--Bo-?|-TM|oX-XTB|EoB------TBXT-MB-TTMTB-TXX-|TX|-o-T-oToB-oM---|-XB-B||TTTT|XooBTX--M-|E|-XoTo-BXTT-o?-o-oBT-BMM--|--TEXoE--Boo--XTB-?-T?B----XXBTBM-X--T-BMT--XT-?MX-TBMBMX-o-X-|--B-BBM?o?B-BE?--
-X----XX-MoTTE-oT-T-----EM|--B-X|EMXoTT-M?-EX--oTX?oMET--Xo|-T-|T-ToX|T-TEoM?-M-BTTTE-?--T----XXTMETEB-E?E--XXME----T-BXTT-BX-?M-T---T-ET-BXT-o-oTM--o-|-BXT-MMooXTTo|BEo|?T-M|X-E??B?XT-?MoEX--|?BE-oT-
--ooMB--?TTB-?X---B-BT-TX--oT?-B--X-MX|X-X?T-o-X-o--EX?-o--o--ooTTX-o-T-?-M-oTo-oXT-TET-BM-oE-?X--TM-T-E-oT?-oX??TB-MX-?TBXE?TEEM??XE--E-oBT--TBXB?E---|Xo-?--E?T--BB--X?B-?-|EBoTo-T-EoTT----oTM---ToE-
---E?B-BT-T-?M-T-M-??|TMT---T?TBXMoo-XXX-T|T-BoMo-XXT-?XX-XXTX-M-ToT--XTX-TTTB--||E-M-?--MT---?-X---MTTBETXT-oT-X---?-XX?T-oX---oMo---T-?EBT-EBX?--|MB----?--MT?-TT?BEEo--BoMoTTT---?-|?M-X|X--Bo?-|-Eo-
-MTXo-E-|ooT--X--XX-|?-TBo|o-T|T?-----MT?-EXTo-o-T--E-?XoT-?T--M-o--T-X---T-ooX---X?MoTX--o--oEM-M-XoBX-Bo--X|-oTT??o--B-?--T|-?XX?ToTo-XEE-T----T-EMTTEoT-MX|?M--?B-E?-o?E--ETTM|-?o-?--MTE?MTo--TXTT--
-EM-o-MTXB??ETX||--M-X--M-?oTTT--o-BToo-?--X|E-?|--BX-TBXB-XT?XM-M--TTB?X-?T-T|--B-ET-TBT-T-oT-?T-BT---E--B--oBT---TE?-EB---TXo?T-TX-?X?M|-?E-XEM|-oXB?oX|Xo-|--?-o-ToTB-BTT-XT--??--T-|o?E-?XoXoTT---Tv
-TT-?TM|-X-oB---Mo-o-T-TE-MTTEE--TB-EMTXXX|-o-M-T?----T|TTX-XB--T-M--Eo-TTTE--|T?EX--EooM?TBT-B?T---o---?T---oT?T|-TTM-BT-X----oMXM-XTM-XX?oo-oT--T-XX?o-BTXo?---B----B--?--T-BM--TMBMEX?E-BToB-o?To|--f
--M?--XT-o|ME--EM--o-XEoXB?o-ooE-TTB-|---oEE--TTBBBTB-??X-T--To-T-X--BMEo|MTE?--T--?-B-TToX||-|---ooT--TMoT-TEToo|--E-|X??B-oT--oM--XEXT|--T--?-MBMTB-X--|M-TTT-TX---X-B?XBME-?T--ooEMTETE|---TTTMTTT--f
-o-|Xo?XMTT-X-|-M-XB--?-B?T|BEB?MXE---TXoT?X--T-oM-BT|o---|TT-E|---B-?-TE-o-TXE?X?TX-|---XX--MXo---ToX|EX?X-T--?T|----Xo-o-oo-X-MT-|EBT|-BToXTXTMTT-XX---XT-BX|-M-TTo--TE-T--oBo??-B|B?-oTX-oBT--?o-BT-f
-ET--ET--BTEo?|-XM--oTM-oEXoBBoMToTBB|X?TT|MoX-TT-?-B-T--oX--|Eo--o-oooo-TXoooMXooE---X-T---|TT-?X|XT--E--TT?--BB?o--T?MT-E-?TTT-?TT-BTB-T??TE-M--?-?T-BXTB--Xo--ooo----T|T?XT--oTM-oE-E-ToMT|BToXXTT-Tf
--BMBM--?M--Xo--?-|---BMB?B|---?B-o-o-X--B-B?B--B-X-MBX--TXBBBE---BoB--M?BXT-To-MB?-X?EXXEEB?oXB?XX---??M-oE-E-o?TMo-----X--?-?--B|-XX-EBX-?MoMTB??T-o-BoM-BXXoX-Bo?B--B?--o|o-M-Xo-?Mo--??MX-?-B--Eo-Xf
-X--XoXo----B-B---?-E?-?--X?X?oXoXXBM?oXXBMoXoB?oE|TEXB-XMX|oo-BXXo-?B-M-XoE?MBBoo----XE?o??XX-ooMX-X--BMX?B-B----XBT?-XoB?-?oBX--BMXMBBEX?-BXX---B?-B-oBX-M---XE-TMXMX-EXXBB-XM---?-?X-X--BB?EX-BX|BX?f
mE-EX--XXXBEMX|---oX-XBX?B-oBBX-X-?|?-Mo--BMX?B--oB?XBBX--?MBo-o?-----B--B--E--Bo-BB-MBoTB-oX-----|-oE|T?-M?BBXBXM|MB??-MB--?MoB??--oXoMBB-Xo--BBB?T-B--XXB?XoXXB?--BE---E-oM-M?-|-EoBMooB|--T-XXM?o-?-X
XXXX-X-XXX-XXXX-X-XXX-XXXX-XXXXXX---XXXXXXXXXXXX-XX-XX-X-XX-X-XX-XXXXXX--XXXXXXXXXXXXXXXXXXX-XXXXX-XXXXX-X-X-X-XXXX--XX-XXX--XXXXXXXXXXX-X-XXXX-X---XX-X-XXXXXXXXX--XXXXXXXXXXXXXXX--XXX--XX-XXXX--X-XXX
