-o------------?EM------?-----------------X---------X---------BM-----?-----o---E------B-X--B--B------------B-----------?----------------------------B--------X--XE-?-B-X-M-------------?---------Xo------
------o----------------------M--EX--o----------------B--------BE------------o---X-----X-----?o--o------------E---B-X----?---o---o?-B---------o-?----XX-?o?-----E-----------o------o--------------X-o----
---------------E---------B--E--------XX-X----B---------------------EX?B-----o----------------------B----o---X-------o-E--------------X---M---M---o---?---M------BBE----------------------------o?-------
---------------X-X----?-----------------M---------------X---B-------X--------o--------------------------M----------------o-----------------------MBM----B---?-----X--E-M------XE---o--BB--------------o-
------------o------M-?---o--------B-XM---------X--------X-X------?------X------------M----E--------X--------------o------B---BM-----------?-?--E-?o----B---------M----------o----o-X-E-------------X-o--
------E-------------------?M--------------------o---?-------------E--o--------------?---------------X------o-----?----o--o?----------?M-XB-------M-----o---?------o---B------------B-----?-o---B--------
------o------------oo--------o----?----M-o----?----X?------------MB----?------?-----------M---BMB-------------B-------------------o----------B------X--------------MX-----------------------------------
--X?-------o----E-----------?---X---M----------?------------------?-----B-------X-------o---------M---------X----------B------Xo--BM--------X-------BEX---o------o--BM----------------------?B---M---?-v
-----B--------------------?-o--------------?-E------o-X-B-----------Xo-B-E----------M?---XM------o-------BM--------E------B-------------o--------------------X----BE-------------------B---------------f
---o-B----o--M-----------------B-----B----E-M----E--------M-----M------------?------------X---------X-----o-----------------B---------------BB-B---XM------------X---------X---o----o----M--?-o---Mo---f
-------------o--X-------X----------?----?------------------ooX?---X-------X-Mo-------------------M-----X---o--B---------------?-------------o-------------?----------o---------M-----X------------?--o-f
-------------?--M-----o-----B---X--o---------Eo?-------o-----------------M----M-X---B-M--------X---X-B---------BM-------E----------------E-------?---------------?---------M---X----------o-----X------f
--------oX---E-X----ToT--X--X|?o---Xo----T-|XXXT--B-BXXT|----X-o--o-Bo---------X--X-----X?---M-------X----oo-B-X-TT--Eo-o-T-o--oTXB-X-TT?-|T--X--?-|M-XXT--BB--Eo----TE---M-oM--|o-|X--T?--EBB------XX-f
------?---T-XTB-To|-X---T-|------T-----B|--TTT?-----oET---T------------X-M----TT----B-X--T-E?-|B-T-E---?-TE-B--TT------?---TT---T---oTX----o--BM----|----M---------------M--T----o?-X---T---M-T--EE--T-f
m-----o-XBX------------X---T--o--o-X--T-oE-E-T-?--TBX-----ETBXB-?o-B---oT-|EE-X--X--|-oo--o--?-MTXM----T-----------M-----B--oTET-B--T-X--o-T---?-T--T-E-M|------------E---X-T----T---------EXT-T---TTMEX
XXX-XX--XXXXXX-XXX-XXXXXXXXX-XXXXX-XXX--XXXXXXXXXXX-XXXXXXXXX-XXXXXXXX-XXXXXXXXXXX-X-X-XX--XXXXXXXXXXX-XX-XXXX-X-XXXXXXXXX-XX-XXX-X-XXXXX-XXXXXXXXXX-X--XXXXXXX-X--XXXXXXXXXXXX-XXX-XX-XXXXXXXXXX-XXXX-X
