----T----------T------------|----X-|----------------T---------?--o---------T----X----B---XE-TXM--------T----o----o----------BM-T-----X---------T----B-------B-----T-ME?----|--B---------B------B----E---
-------?E--M|------T---------o-T--B---TX-----o------------------TM----E-T--E--BT-TX---------------?-M--T---------T----Xoo-----T--??-X---o?-X---------TMo--------------|-T---?o------|--o-----o--T-?--|--
------M-----------X--X-?-----T----------------X-------o---o--------E---X---------------------T--------M-------o--T-E----?--------------------|-T----o----T--T--------o-----------------M-----T-TE-------
----------M--------Xo--T---X-M-T----T-----T--BB-----------B-----------|--M-T--T-o-----o--B----------M------T---TBo---T--T-|--BE-T-------T--T-X----------TT--------------o--B----X--------o-M----?---X---
---T-----T----E-T---------TT---------------------??-----XX?-TTo------------------T--T-BT--B--oX-T-----T--------------EoE?--M-B--X----?----oXT---TX-B---------------?---B---T-----------TTo-XX---X-T--Mo-
-MTX--------T--------?--------T-TX--B------|-----T--T-B--T----M--E---------X-----X--|--------E-T------------T---M----------------o-----------TX-X------B--------------B--B------X----o-------X--o--oT---
---TT?-----o-T----X-------T------------B-o----?-----------o---T---X--E--T-T----------------o--E----?-----X---|-E--M----B--XB-T---oo-----?-----o---o-------X---o-----o--T--------?-X-M------TB--E--------
---------MX--------X----o-------E------oM--?----------X---T-T----T---o--T-M---------T----T---Bo------E-E-------Eo----------------X--------------?-------?-o-------T-T--X----o----M------BT--------T---ov
----oET-?-?---X-----MX----X----o-TM------E-X------T-XX---------TT---?X-MB-|--X--oB----------T--------|-T--oo---B-TM--o----------o-------------------|----------------------X------B----|-------T-M----of
--------T--X-------|T---------o--o----X----?M-To--------E--T-B--B--------T------XX---------------------E----oX-T-------------T------T|--|--------------T-T-T-T----------XX|------X-----X-T----o--------f
---XX----|-----------o----MX-------------------X-o----o----BT------o---B------|-E-----Eo---?M--oM-o----------------X--------------|----?------o-----|-E-T--E--T--T--B---o--------T?--o------------o---Bf
---X-----o---oX--?---o---T---o--------------B--o-------o-T----------M-T--T-----o-M------oXT-M-o-----------------B----o-B---B-T-----------B-To--------------B?----M-----T--------o-E-----------B-?----T-f
--T--T?--X-M----o--B----X-?o--o-ETT-To-T-T-To|--E------o-TT-X-ooo---T---B-o-BB-----T---X--X-oEEXB|--T---o-X------X--?-T?--B---M--X---EM-EoX-M------T-ToX--T-T----oX?---X--------XXB---?-------?-T----|-f
---M---|oT-TTo---T-|XT-T--TM---oT-Xo--E---------M-?--X-----o-----|----X----?-----T--E-M---|o--T--B---X-----EM---To------X--E-|---Bo-|BX---MTT-|?-?----X-o-T-B-|--|?---T---B-T---XE--TT--XE?o--T?-T--B-Tf
m-----?-------M-|------------T?-----M-----B-?--ME-o-X--ooX------EB-X-XT----B-oB-E---T-M?----XX-?BT-----T|oMo?E----X--o-To-X|-T----------o--BT-o-------|TB--E?TMo------?BET-o---X--?o|EX-|--B-M-TB---?-TX
XXXXXX-XXXX-XXXXXXXXXXXXX-XXXXX-XXX-XXXX---XXXXXXX-XXXXXXXXXX-XX-XXXXXX-X-X-XX-XXXXXXX-XXXX--XXX--XXXXXXXXXXXXXXXX-XXXX-XX--XXX-XXX-XXX--XXXXXXXXXXXXXXXXX-XX-XXX-XXXX-XXXX-XXXXXXX-XX-X-X-XXXX--XXXXX-X
