---o-?-----------B--------------MM---------------------o?----------|--------o----------M----------X--X----B--?-----M-----?----o----------------B----------------o-------X-------?------?-?---oE-X-M-----
-?----X-Mo------------oM------------B------------------o-------?----?-------------E--------------------X--Xoo------o------------X-------------?--------X-Bo----Bo------E---X----------------B-X--XM-----
---B-----------X-o------X---------------o-----------o------------o-------------X----o?---oX-----X----X----------B-------X---X-----------?--------o---------o---------X----o---------------E----------M--
---??---?X---------E----------------BX---X--------------E-----?----B---E----------o------X---------X----E-B-----XE-M-o--------M-----------B--------E--BM--o----?---------------M------------------------
-X-?----o--------Mo----M------?-----E-----o----------X-X----X-----------M--X---------E------------M----------M---------X-?---MX---------MM-------------o------------------Xo---o----X----?X------E--B---
--EoE-----M-----B--------------X-----X--M--------------------X-B----B---X------o------------X---X-----B---?--B--o--?----------------o------------E-o---o----------o-------------E------------X------B---
-?---?-M-o--------B-----?--oXX-M--E--E-----BE-------B----------E-X----o----?-o--B-----E---X-X------------------------?------B---B---------X--------M-X-----------E--X------------E------------BX--------
-------B------o--E-------o-----o--o-------------------------?E-----X-?----M------------?------?----------o--o-o-----------?-----X---?-----------------------o-------------B----E-------------o---------v
--------?-----------------------o--M--B--?-----X----o-X-X----------o---------?-------------o-M-----------X----EB---B----------o-X---------------------X-X--?-----------M-----o-----M---------E---oo----f
----E--------------?-------------------o--------M?------B------M--------------X--------X--B--B-------X-------------------o----X---------------------------------------EB------X-----------------M---o--f
-------XE-X---E-----X-?--o-BE--o-B-B-----------------------X------------MoX--B-o---B---------------B--B----?---B----o----o--------------?------------?X-E----------------------BB---B----------------X-f
---X-----------------?---M-------X--------X----o--------E--?-------B??---------o---E----?E-X?--X-------------------M---------E-o-E-----------B-------E---------------------------E--o-X-X------o-------f
----X|oT?--------T-----?-?Mo-|o-ET-TM------M-M-oM-?X------BE--M?M--X---o?-?XT-|-----o---X-?T-B---X---M--?|M?--?T--------EMEoB---?--------ET---Mo-B--E---M-T?X-----|---TX--X--X--TTBT-T-B-E-X--oX?-o?-o-f
---T|--E-B|--E-X-?---T?o--M--EM-X---X--oT--?--|--TXB-----ToTTX------E---------XT---MX--o---X---o-E-oET?----ET-ET---M--TXTT--X--BX-o-----oET-XT|-To-----------X-XT-o---X|ToTMT-T--TT-o-?E|TTXBoTE-----Eof
mXX-o--?--EoB--B--?MEB-|MMET?-----Bo--X---|Bo--X-o----ooTT------o----EMET-?----oBE---M---X--B-?TM-T--o-----o-T?-o-----XE---X-TB--oT?-B----E-----E-B-|-TT-------T--T-----BB--BTX-----------T-?T-B-------X
XXXXXX-XXXXX-XXXXX-XXXXXXXXXXXXXX---XXX-XXX-XXXXXXXXXXXXX-X-XXXXXXXXX----XXXX-XXXXXXX-X-X-X-XXX--XXXXXXXXXXX--X-XXXXXXXXXXX-XXXXXXXXXXXXXXXXXXXXXXXXXXXXXX-XX--XXXXXXXXXXXXXXXXXX-XXXXXXXXX--XXXXXX--XXX
