-E-E--------|-------M------?T--X---Xo?|-|T----o-B------------oXX-?To----|-?---Mo?M?----XXM|X--MM-----X-MB---B-o--|X-----B-M--E-----XT-X---B--X-B-|?--o--EX-B--Xo-|-BM------------E--TT---?-o----M-B-?---
--?---|B-M-B--TX--|B---------?--T---XT|B--XB--o--o--|EEE-------------X-----B----?BX--------------E?---|--T-----X--E--------Eoo-o---X---------E--X-?--T-------B----o--Mo----E|-?-XMX-----XT---o|--oB-----
-Mo-----oT-----o---X--o-----B-o---Xo--T-|---??X--o-B-o-B-------?-M---|o------o---------B-E-o-E-X------X-X---X-o-|------B--T|---?--EM-BEE|-o---E-TM---?-M-?---E-E-----?M--X-------------?|-X--T--------T-
-XX-E--?o|ME--T------B---E---MX-o--BT---E-XEoB-------|---MBX|------|---?----M-|---XX---EB-|--------TEMB|--TX-B--T---|B-X----BT-XBE--XT-X--o----o-T-B-E-B|E---?TTX-E-----o-XX-EMoX---Bo-----------M--B---
----|MTT-B-EMM---B--------ETME-B--M|--|-----T---M|---------|--B--|----oBE-----?M------B--Xo--X--B--o----E-?----MX-----oT----o-|X----|--?-B---X----o---|-----MT---M-----T-BM||---Eo-B-?---M---BME--|o----
--oBo|----X-----BE-----E--o--XX-X?E-X-?--B----------?----------To--TMT-B?-B----B---|-------X-XXo---E-------X---Xo-T--T--M----X--E---B-BXM-|------?--X?-|E--T---o--X-o?-|E-----X??MBT-MX-B--T--T-M--|-T--
---?----|---|-------||----E-o------|--T-T-E-------?------M-T--oT---T--XB--B--o---|-----|----B-M------B------X-T--------------E-----X?--E-E-----E---oT---------o---o--X----oE-|o-T-----------X-|--|M--E--
-T----oM----E--o---?--T----E-ooX--?o---?XX|-|----?-----|E---------TT--X-B|oEB-BT-----T-E?M-B--|-|--M-T-T|-|---TE--B------B?-?-B-BEo--|M-o-X-M-MT-M-T-BT------Xo--X---E-----?-------?-|--MTMX---o-o---oTv
----o?X---|o---E----o-o-Bo--XT---o--M-----E---TB|----T----------B?-----M---B-?---T-o---T---M-E---ME---|o---?--------M-M---M-E||-|----o-----oEEMM--o|B?--E--o--o-E--o--?--------|--T-?-T-|---XX-o-BB-?T|f
-o---?--X------XMT|------B?o------?---T-B-X---E?M------EB-?X--M-T--XT---MX-?-E----BX---------M-M-?--T---M|--B--?MME--o--B-?MB-----B---E---E--X-T-MB----X--TB----|TT|--MB-----o-M?M?T---|-----EM---T-o--f
--?-----E----E---T-----T-|-M-----M-?-----?M--?-----B----?-M-o-|--o--B---M|T-o?----E-MMT-|-?----E-XT-X----EMX----?T------|T-E-MM--oo-o-||-----M-oT--o-E---T-T-o---|-|-BBT?o-?MX-XBT-BXX--?---------|--X-f
--B-?-------BXT----Bo---B----|-B----|MB--|---E-o--oT--BT--T-----M---------?--?--o-X-----|----E----E--T-T-T--B-BT|-E-|-oo---?-----X-----------|-----|--?X---MX-?-MX-----T---|-----TEo--?--oo-o--T------Mf
-?--XMB------||-----E--E-M---o--X--?---TXT-|-o-X--o-o--M-XoEBT----o--BT-T--E-X|---M--?|TM-M-o--|------E--?-------Mo--?-X--X--BE-?-----XM?BM--MT----o---B---B--E-----B-X--?M--E--o-----?E-|--o-|B---X---f
--M---MT-X-EX-------ME-M-XEE--B----X--?--E---X------E|--M-E-o--X?-X|X-|-B---MX---?--E----oEo-M--o-?----------T-?-o----|--E---B-B--E---------?X-M----B---M-?E-E-T----T----B--?--TX-M-Mo-TT-M-E--|-----X-f
mE--T-??-----M-E---|?-----M--------BB----B----------?M----XE-------Xo-E|-----B-T-----------TX--X-TB-E-----M------o-B-oB-------oB--??E--|-------T--B-T-T--------Bo-------EoMEE--B---MX--B-------?X|-----X
XXXXXXXXXXXXXXXXXXXXXXXXXXXXXXXXXXXXXXXXXXXXXXXXXXXXXXXXXXXXXXXXXXXXXXXXXXXXXXXXXXXXXXXXXXXXXXXXXXXXXXXXXXXXXXXXXXXXXXXXXXXXXXXXXXXXXXXXXXXXXXXXXXXXXXXXXXXXXXXXXXXXXXXXXXXXXXXXXXXXXXXXXXXXXXXXXXXXXXXX
