--------M-------------------M-----M-----E-o--B---o---------------------E----------?--E--------X---X?E-E---M------MM--?-B---------EB-X---------?-?------------B------------?M--------B-B---MB-------E----
-E--M--o-----o-----------------o--M----o--EX-----------------E----XMB-EE-E-----E-------o------------M------o-----------B-------E--------?--X------o-------------------MM-X-?---E--B---------------------
----Bo------------M----------B-----B------B----M------M---------X---?---E---------o-------------------X--------o--X-BoM----oX---------------o-------------------o-----------X--------X--E?---------E----
--------------o----------E----o--------------?--------------o----E--------o-?-----------------EM-----E--------?------B---M---------?---------X-----?----------------------X--o----oo---------------X----
------------------X---o-------?-----X------o-----?-----------XX-X----o---------------------o?-E----------X--------X----o-X--M----------X-Eo---?------------?-----------XB-----o-------------------------
---o--X-M?--?--------------o--M--XoE-------------?-----------------M---------E------------------------------------------?----------X--?------------X--------------o-M-----------------------X---B----o--
---X---------------------X------X-?-------------X-----------E----------B-------X-----------------------o-----------E----?-------XB----B-?-----------oX-------------E-B------M---------X----?o--o--------
---------E-------------------o--M-----X--X------M-----B----X--?X-B-X--X--------E---------------?------X----X----------------------M-B--------X----o-------X--------?------B--B---------?---o-----------v
--oM-------------E-----EX-----E-M------E------B-----M-----?----X?-X--X----B----------o-------------X--X-X-o-------?--?-M-------E----X-----oo---M--X-------------?---------o-?----M-------E-E--o--------f
-X--------?------o----o----?o---E------------------------------------------------------E?Bo-------MBB-------------X--------X--X----------XM---o----------?--XM---------o-------------?-----B-------oM--f
----o-EX-X----oo--------------B------E-----E--------------M-------?-----M-----X------------X------------X-------o------ME-----M------o-B-------------------o---------------------------------?----M--o-f
-------B----Xo-------B--------EM--------------------M--?-?--o-----o-------------o-----------XB-o---XX---X----------------?---o--o-----------B--X--o-X---------------E---X---?B?----o--o-B---M----------f
---B-MM---TT-----X----T---?T--T--------|-|-T-TX--?---M-o-o-T-XMT-TX--X---M-E---T-B?--E|----oE---To---------|------o--TT-TT----oT---?-----Mo---X-M----T?---BE-B-------TE--------o?oB?----T-----M-X----|-f
-------T-----TM-E-T-B------?-oTT---?-?B--E---BX-Xo-XoB-?---M-??X----BTT----ooT-----T-T---TT?o---B-?TTT|XX---B---|?-------?oTT-XT-X?---ToTB---Bo---X---------TE-X--M-To----BBTMT-M--Xo--X---T---EEo---Tof
m----?T----?-?T---X--B-o-Too---B-----B---o--?----?-o--B----T-E-oT--T--o-B-----T|EX-B----T----T--------T---|--?BoTTM---B?--EoX---oX--B|-MBM--XoX-o?-X---XB--|-----|------T--oT-M-oX---X--------------MB-X
XX--XXXX-XXXXX--XXXXXXXXXX-XXXXXXX--X-XXX-XXXXXX--XXXXXXXXXX-XX-XXXXXXXXXXXXX-XXX-XXXXXX-XXX-XXXXXXXX-X-XXX-XXX-XXXXXXXX-XXX-----XXX-XXXX-XXXXXXXXXXXXXX-XXX-XXXXXXXX-XXX-XXXXXXXXXXXXX--XXXX-XXXX-X-X-X
