--------|X-?T|B??---o--Mo----------X-E-||---o--------------B--MB--M-?-EM---E------|E---|-|---E-----oE--B--||-T-T---E--T-M-?M-M-B----|M----M-ET------?-B---EB----M--MM|----M|--E---|----|-E---|-M--------
--|ET--T-|-M---B-?------?o||---o--M-----ME--B-o?-M--Moo-|--|-Mo--?---E-----o?B?-|-|---X----E-?M--M-EE---M--XB---B-----XMX?o-T-----M-oTo-o---E-?------------o-BEEE----M-T-E------------B-----X--TB----M?-
--M---XX-o-B-----o-|--|----?------M--|----Bo------o---BMB-X--E--M?-----MT----M-X----M-B-?------M----|----B-----?--?-?---M-M---T-B-MT---|----E--o---|-T-M-B-|-T-M?-?-EMT?-o-T-------E-----o-oET-M--?--B|-
----E---EBM-------------E---E--B-T-------?M?-o----?------X-M----M---|---B?--T---?---?--E---|--o-----oX----X-B-EE--B------BE--T-T---?--|--o-M------M-----|?-XB--T|---oT--o-XTTB-----X-X--o--E-M-?-M---|--
----oo|----T--?-M-E--X----?MT--ET?---|T---o-?M---MoT?|-----oB--BB---E---------------M---o|M|B-??-B---B?---|--o-XM--|-TBBB-T------XB--------------|-------BM----------------?T---T-----X---o?X--E--X--BT-
-M-X-|----o-T---?|---BB?Xo------?Bo-M-B|-T--------?-MM--X--|------B----o--?-X-XM-B-E---------E-T-?---?-o-B|--X-X--?|-MBM-------E--M---X--?--?-X-----M-M-TB----|-|--------E-------X--E---To-------?B---?-
----X------T---B--B--B----E-M---------|BMBo----X---B--o|--Eo--X---?M-----X-E-M---M-MB-X-o-----E---o---TB---?-------X-|-M--?--X--?o||-------E-XB---MT---T----o---------T-E-o--------MXX-|o-X---E-?---|TB-
--??---M-----X-Mo---o-------|E-M-X|------M------E--XX-MB--XoT?oB-o------M-o---|-MX-------B|--TT-|---oE-?-o-T-----T----T-oo|-EB---|-XT---o-T--oo-|X--E-|o-----|-o---B-TT---|--|B-X------EX---X|------?B?v
-E---|--TE----E-----X|X-EB---|-M--Xoo-B|-------M--o-MX----B-|T---EM---------|--M---Xo|-M--T---------o----EB-B-X-----T---|-o|o-o-----o-|-?-----o-?--MX|-?-?M-M---M-MBB--|-?TTo|E-o----|-----X--?XM--E--Bf
--|-----X-X---X-MT-oTBB------|------?M-----M-o-|-|E-X|-TM---To---------o---?-E-|--------B-----|-Xo-M--o-X---T---X-------EMoB-|?----|T---TB-----X-|--------E---B---B--|T?|---E---------T-?---T--||---TM-f
-T?------|-B----------B-|?-|-X-------M-----BB---?--B--E------M--|--o--EBM-EoX-X-T--B---?-------B--X-TX-o-M---|Eo|E-M-B-oTTMXo-oMo-----o-oM---B-M--TE-M|-M------|--||E--?X--XMB-M-T-?-B---|?--o--B?EE---f
------M----o-To-M--o---BTME--oTM?-X|X--B--T-B-E?-T-?M-E-EB-----E-o-M-BB---oMT--------oM-----T---o-----|-----X--?----X??-----?------??--oX-T----|-----T?MB-|-|------|-----B-E-B---EX---T-XB-?o-?--B----|f
--?---------EXT--------|EE?--------B-----|-----X-M|E-----M--M-|-----M-o-|---|-M-----B-E-?MX----B---B---B---|--X--|--BX-X--T---B--M--M-MTo--o-?oo---M-?M----?-T-----E-----Eo-|--?---MX-EM--|--M-B-?o----f
------------------T----oE---?-|-----M---X----|--E---E-B?|--E-----E?--o--T?--------T--?--EM---XB--|--------o-E-----T-|--------o-?---ET---T----T--TX-----?-|-??------XoE----B------EMX--B-X-B-TM----|o-T-f
m-X--oB---o---?E---EME-----------X-B-----?--T-?-?-------B-|X?X--||T-?o-B--?X-X|o---o--E--XE------?--o------E?-----E-----|--B---------M?|-------XB---|----XXo---|-E--T|------B--T|-T-XX-?-oM--o---M?--o-X
XXXXXXXXXXXXXXXXXXXXXXXXXXXXXXXXXXXXXXXXXXXXXXXXXXXXXXXXXXXXXXXXXXXXXXXXXXXXXXXXXXXXXXXXXXXXXXXXXXXXXXXXXXXXXXXXXXXXXXXXXXXXXXXXXXXXXXXXXXXXXXXXXXXXXXXXXXXXXXXXXXXXXXXXXXXXXXXXXXXXXXXXXXXXXXXXXXXXXXXX
