-oBXETXM--T??XT-T--M-o?-?T|o|B-XTT--TE-ET-?-?-X?--?X?o?ToEB---ToToTM-X?TX|-X-oTT|M-X--XX-T-oTT-X-XTE----X-?-EM--MM--?ToB?---E|--oETTE------X|X-oB-E--X?XXT-B-??MT|EXTo--?TXTE-B?TXB-TT--X-??T|Xo-oToT?--
---oTT--oX-T-??-MET-MXoTB?T---E--To-oEXXXT-TBTMTXT-?oE--X---To-TMX-TX---MTo|o?M-?|T-|T-o?-XET|To-BE-BoXB|oM|T-?XXM-oT--TTT|X-o-X-?--B-?-E-M-B?-Mo-MB|B-Xo?BXET-EM--MMMXBEoo-TXT-B------|Mo--XXBMT-TXE-o-
--B-XTM?X-oM-EBTM-M--o?BMT-BE-o--?--?-Eo---X--BX-EE?TB|oB-X--EMooT--?oT--T-?BMX-Eo--BTX-BTTTTE-T|-B-BE-?--TT-MMoB-oT-TXTT-o-o-TXTBo?-TTX-TB|-|oXTToo-TMT-oTTB-XoX?TB-MoBM|T-To-B?-X-MB?oo--T--TTTXXo-oo-
-T--?MTT--o-oTT-TMB--TEo?T-M-ETXB?-BXX-XE??-T---?M-?--BB--TTT--TTooTX--X??--X|MT--T--?T-MBB-E--M-T-To--o--T---XT??oXEBM--?|-E-XoT-X?-TXTM--T|-TT-T-B-T-o---M-T--?--T-?E-XooM-ToMBXT--T-B-E-X-TE-T-X--TB-
-EE-BTMB-X?T-TT-?MT-E-EXEToE---TXX-T||??EE|T-XoXT--M-?ToEE-B--XXBMTo?-To-TETBE--XE?oT-------oMX--EXM?B-TE-EXXB--BMT?EXE|-B--?TTTETB-ET|ooB-XoB?---E-X-MoT--XTT--?BoX?-|-T-oT?-ToT-X-o-X?--XB?o-T-|o-TET-
-TMB---T|T--M-o--|B|--B|-T--o-oB|-BEM-ETXTE?--X-ETTo?-T-oX-T-X?-X--EoBM-M-o-X-----T-TTT?-TMTB-E-M-XX-TBEE--|-oT|Xo-|B-EEM|---T--oo-X-T-TXXo?MMoTE|o?-?MMT-oo-TE-TTXToo--TX-|MTETE|-XTX?M-?o-MTT--BM-TXo-
-MM-M-TT--ToTToo-T-E--TBX---EX--MX--EXoToEETXEMMTX--T-----Mo-X--TT-T-XEoEo-XBM-T-?ooMT---E-o||o?E|oTE?BB---|TEoMTooMBX-o-TEX---MoT--?BTE?o?--oT--TMT-|--?---X-ETXB---TT-BBEoM--TMToX--??o-MTM-oXBX?EMT--
-B?-X-T-T|-|?XMX--o---EM-T-T?BT-TMBXXT-oToTB-?TMXEXB-TTT-B-----oMTB-BT----o?XT-|E-M--B-E-TE-ooTB--TXT-BToT-BEB-MoTT?o-oT-?TX--XBBo--?--??---o-T-o?o-ToXE?TEoTo-oMoMXoo-TT|X?-EX-?o-oT---XET-XT|B-M-|-oBv
-TTBTT-??XT--Xo?XM-oX-M??To?-TBoM-?-XTX-ooE-XT-B--o--?o-T---B?o---MMo--o?-BoXT-o?T-B?-XET--oET--?--|B-BXT|?TX-TT?B-ooo-TX-TBXXXoXT-?ToTo|M-oTTooXXX-TT-X--oTM-XToB--TB-?MTE?XoXXE-X?X--BTT?BTBoXoBT?-TXf
-XM--T-T|o-XETo|E-TTE---BoX-?-XMTTBTE---XTBoo?-oXoEB|?|o-X-TT?oTTBTX?-o----M--TM--TXT---XMETo??XoX-ET-E-TB-M?oX-T--TMXT----|M-T-|B----oX-E-oE?TTB-T-XX-TTXMo-|ooMXTT-Mo?-XBoXM-T||-M-T--T|-T-E--E-XEo-Xf
-oEToX--MXEoEo?T?-XoBo?o|XB-METTX-o-T-|oTBB-TMXM-T--|??--TB-TT?-o-XXXoBBT-BToT-oX--XM-E--o-?TXTE-o-BToM-|-oXTTo-MXXXXoX-X-X?B-X--TX?-?|TXMoXEXXBXTBE---?TBoXXTEo?B|-XoMo?B-T?--X-T-o-E--?-XoE-ToX--o-T|f
-T-oBB-XTo------TM?-Eo--|T-TX?-B-o-E-XTBTBTE?TEXooT--E--oTBXo?-oET-T-TXo-?-o|oT-TT-T--XB?TTT-o|To-T---B?To-M--|-XME-M-X-?-oTT--T-XM-BBX??|T?TTB-|oX|--||BM?E|T-XME-T--BTT?oEXB---M-B-|XT|---oME-o|?|BoXf
-X-Bo-M--BXX??EB-X?-oo?X--B?---MB-MEB--EToBB-M??B?EoB-o?-o-M----X--X?-BX?X-BE-o-E-XMo-oXXMBXooXE|o??BEBE?MBMX-oME--E?BEoo-BM-?MoX-o-BXMB---?o?-BX--BM?B?EBoBB?MoMXMXMXBoB?XoT--B?-oX-BoM-EM---M?-T--?-Xf
-ME--B-?-Eo?XMMX?MM--oo|EXB--MoTXXX?B??BBXE-oM--XB-B?TM?oo-o-o-B?X?BoM--B?E--XXX--oXoX-o?B--X?B-?MMo?oMo-BoM-B-MX-ooMM-oM-B-oB-?--B-Bo--X---E--?EE-|XX?E-B?X?oMoBMMME-X?X-TooBoB?XMo?XT?-XoMBM---Xo?B-Xf
m|oo-o-?EXM----ETo-|?oX???MBT-X?----?-ooB-B-ooXT--BB-EXXMMM?BTXB?MME?M?-B-X--?-?|??BB?T?X?-X-?-X-XMXX---XB-?--EoX-?Bo--B?XM--M-X--X?X-XX-X-o-?X?To?o-X--X-XBoX-|BX-XoTEMMoB-?ET-X?o-XMX-BBX---BXB|?B-oMX
XX-XXX---XXXXXX-XXXXXXXXXXXXXXXXXX--XXXXXXX-XX-XX-XXXXXXXXXXXXX--XXXX-XXXXXXX---X--XXX--XXXXXX-XXXXXXXXXXXXXXXX-XXXXXX-XX-XXX-XX-XXXXX--XXX-X-XXX--XXXXXXX-XXX-X--XXX--XXXX-XXX-XXXXX-XX-X-XXXXXXXXX-XXX
