-M--------BE--X-o---?o--------?BE------X-B--B--B--E-o-B--o--?-------M---?-o---B?--M------E------M?B-?-EoM-B-E------X?-E-o-M--E?M--EEX-o------EBo?o-BX---MMX-E?X--BM-EB-MXBX--o-----X------X---?-B--?----
--?o--X------XX-oM---------M---?-BE----o-X-?MX--Xo---XB-M-Bo-o--X-B--o?-E-------X------B?--B-----X--B----o--B--EMEM--?M--MoX---------X?o--o-M------E--M--XX--E--o-Eo-E--B-----M-----B?----?---XoB--B----
-oB---------E----X---X-M-E-oM--E-EEB----X---B-?--?--X-E-E--o-X-?--M-X----o--M-----?ooX-M----oX------o-BEMooE---E-o-E---B--E-MM-oo--B?-----Xo--?-----M-E-oXM---MM--??----------oM-----oBo-B-E--?----oB---
----?----??---M-B--o-M----X---o--B--??-oX---X---?-X--o-----M---E----B--X---B----XE--o------?-o--M---?o----------X--B---?----M--M-M----o-?---------E--o-E----?-?----o-?-E-E?-E?--oE---?------MoX--B--?-B-
---XE---------------------BoX---?EXE-----o-oB---X-X-EB?-----oB---BXM-E-M---o--X--MMB-Xo--BoEE----B---X-B-E---B---?o-MB-X--o-?o-B--B-?M--E--------M-X-X-o--X-o-?--o-----?---B-E--BB-----X-----X-M---B----
-o--M--------M---?E-----M-BoB-E--?oM---MoB----?M-o?B-----?---B------EMoBo-o--E?M------BM-X-BE?--B-X----?-------??-M--------?X----Xo--X------B-E-X-oX--M---E--XoE-----B?-?X---o--o----BB----?-------BE-B-
--oEB---E?----B-------B-B------?---?--E-B---X-M----E------M?X-X----EM----B--o--BXBB--B----E-oX-B--EB--X-?XE-------X?-EoB---X---?oE----E----B-------X---E---MM---X---X----------Mo-B-M-B-?X------MX--EM--
-B--EB----------EX-X-----X--X??---X?--------X---M------EBXoo--M---o-?M--X-----?B---XX--X--?--o---XB-?-X--B-M-----X-------oo---o?-o---?-M--?X?--EX---?EM-M---B--E-X-?-M--BX--?--?----B-?oB--X--B-o?-----v
-X-?-----M-E--oo?B-E---X---o-E-E--?---M-B-?XM--?o----ME-E------?---o--B?---E----E-----?oB---B-MX----------BE-Bo---B---o----oE--Eo--?XE-B-M--X-o-Bo--B-E----M--EX--------?--B-M--?-------o---B-EB-------f
---------?B-----B------X-M---E-MBX----EMo------X-M----?-B---oXM-------?o----B--X?M-?M---X-XX----E---M??-------Xo-E--?---?-----------o------M-?--?-------X-MM-Bo--EM----?--M-X?E---X-M--?-M-B-X?-E--?MBBf
---EXX---?-----------MM-------X--oo-----X----?Bo--E-MM---o--B---o--M-X-?-----------?X--o-o-?---oMBM--M?-o--M-------------o----MM-M---E---M-?--E-o----------o---X-B-XE-o-B--?-X-?-----o--X----MX----B--Mf
-B---B-?-o--EB-----o--E-M---------oM-BME-E---??---X---oX---o-------B---B-------o------EX-------E------M-M?---oMX-X-----o-E--Mo--M-E----M-X---M-E--o--X---X--B-o-X---o?o-----X-X-----?B-X-------o-BoM---f
-------?-EM---M------M----B--?-----BE-oX-?B---MoX-XBEX---B-E--?----BoMM--M---M--X-----B---------BB-oE?M-M---B---B----o-E--?-M--B-XM---XoMX-Eo--?M---E?E--------o-B----E-?M--BE-?-X--Moo?B-B-XM---o?--X-f
---B--?o-X--------oo------------ME------M-----?----Mo-M----EB-X-X-X-E-o-----X?--XB--M--EBXMoM---EBXE--Xo-o--B-------?--------o-E--M-?oEM-Mo-?------E--B--?---E--M-M-----E----------M-X-X----o----B?----f
m------------------------------------------------------------------------------------------------------------------------------------------------------------------------------------------------------X
X--X--------------X------------X--X-X-X-XX--------------------X----------X-X------------------------------X--XX----------X--------------------X-X-----------------------------X------------------------X
