-T-To-??MoETBoM-EBoEoT------Xo-?-T--XoXMXBBT--o??|-T--TMM-BoXM-EM-TE--?B-X--oXXT?|-E-XTo?MBo--T-BXTB---TBoTT-XT-E---TT-|-XT-M-TTTToTBo-BBTT-X-T---XMXT-X-XB-XBXBX-TX--Boo---o-??X--B----M-X--X--oo-o----
--o?-T?--BBX-BB-|ET-XX-T-M--XM--B-T-oTM--oXTTT-TX?TX-o---EXX-|-MM-BTBo-X|T-TE---oX?-|TM?oE-MXMX-ooTXM-MEoTXT-|?B-M-TX-?--B--XTTX??--T--ToToB--E-?-|TM-XMX-?M--Bo|TT?---MT--oT---o-o-TB-?-B|T?X?--oo-TMX-
-T---ETB--M--o?o|--ET-E-XBEEE--XoBXEXETTT-MTBBXo-o---E-X----?-XTE?-T-o----?E-|o?--B?-X-T----oBB---ToB-E-E---E-X|MoBE-MXETo-?|-BET--oT-|X-TTT-BTBo--T---XB|To-----XTo-T-E-?TTX?XoTTE---o--oBEEo---TX-XB--
-o-?ToXXBTEXT----X-|TXoET-oo-|M---B--oX--o--TM?-BX?M--X-T-ET?--ToX-o-XM-TX-|Mo-EMMX|MB-|-oTTX-X|--oT-T-T-X??T--?M-?BMTTX-B-?-T---|E|?o-Mo-?----??EoB-?M|-T?X---TTT|MM-TXo-T-M?--XE-|oB-TE-?-BoBET-oEoX--
-?o-TB?BTMTToET---M-o-XT-XB?X-X?oT-----B-|TT|Xo?-T---X-X-MoTXX--?---X-X-oXM-TX-Mo?-T||-T-TB-EM-T-BM|-X--B-oMoTTBXTX---|-To-X--X--XXB?-TM-?-X-ToBB-T---TTooXo?TE--?BMB-MTE-MTBXMo---T-?-oX---T|TBEo?BT-X-
-oBo--EXM?--T-XTBE--EXT-oo-M-MBXT--XXX-XB---XXXTXTBBTXo--T------XTT-T-XMX--T-M|E--TE?--oX-XMXXBMX-EBXo--o|?T|-?o-B--?-o--X-MM-T-E-??T-Mo--oT|o--TB-TTTX--T|?TMM-|oX--EToo-TM--T-T-B-MTM-MT?-oMTo-To--BX-
-METTT?o|T-|ooB-MX-EEB?-TT-T-XBTBEE---T|ETT--ToEET?-?---BEo-oo--T--?XoT-|oBTToEBTTT---o-EB-|MT-MT?B---EXoXoTXBB-T?M--TT--EBMB---T|o-?TT?-?oT---Mo-Xo--|T|BE-T--?-E----oToo-B----E--XXE?----BBoX|--?o-BM-
-o-TTo-ooT--BoX-|-|?TTETT-E-TMXo-?-XXBEE-|--XM|ToTXEo--XBo-MBXBT--?BoTT-o-BoB-X|--ToXT-TE-T-|-?--oBTE-?ToBo-BEX---T--XoEXETToBM|?B---TT?B-TBT|-TTMBEToEBoT--?--B-TX-oEBToT----TTB-oEMEX---M-TXTBEE?E-BBv
-oTT----|XTo-Xo-----TB--X--|o-XoB-X-T-X?--M-MoM-T--M-----ToTM-o--X-TT?-B-T-T-----?o-X-TXoE-?MX-MTTToXo-BToXoB---X??XMTTXMoT--XB-X-T?-o---o?BT-?-XXT-XE----BTXMMTTX-EM?-|-BBXXBB--To--XX-TTXX-BoX-oT-Bo|f
-oMMTT?TXEX-T-B|-|To-?-B-?|E|--BBT?TT---oX-T?XBT--?-To?T-B--B-|T--?T?XTEX-B--TMo--BM?oE?Xo--oXoToX|Xo-M-ET--?EToTTooXBT--?BX-oTT-o-TTTE|BXBo-o?MT?TT--TT-M--BX-M-T?E-T?B?E-oEBE|ooBMTT--?B-E-----XT?XEof
-T?Xo?--T-EBM?ET?--M---TB-?T-T--T-T-EM-B-T-BE--?E-XT-T?X-X-||o-MMToToT|-T--XB--T|--XoX-TT--?T--To--oT?-|--?M---XEo-X|-|??-XE-?---M-TEo?EXTBTEo?oBXTo-?BEoM--X--Xo---M-o---o--?TTTTBE-|--T-XX?X-E-XBB-?-f
----TX--XTT--T?-?T?ooo-o-X---XX?BXT?TBBX-Xoo---oT---MX-?XTT--?BTX-TBETo-?--Eo-?T|TXMTE-BMT-T---Eo-E-E-?-oo-ToToXoMB-TX-T-EEMTT-B-To?T-T----o|XTT-?TBXTX--|-T----T--E-TTXX--T-ooT?EX?E-X---TX-T?T--T-X-of
--Bo-o?B-BBT-XXX-X-o--BX?X--EX??XooBM-o-?-MXB???-XEoB-XXB-?BXoo--ooE?BMMT-XoMB-MM?XoBXoBB-E--M-oXo--BB-BM-BE?BBMX-MBBXXXB-M|-X-XXXM---B?--ooB-EMXX-T--Xo-|BX?X---EXMMoXX-X-BT-|-oXX-TX-|XE--?BEoBo-EB?Ef
-BBE--?X--oX?MX--MBMB-X?E?-oBXX?XXX?-E?---EBX--BXX-BBT-?XMTo-XX-?-BBB-----XEXBoMX-XooX--Xo-?X?B?oX-oB?E-?o--MXoX??B?o?--M--oXoM-XE-?--T?XX-EM?BB?-XoB--XXBo-?X-|Bo?B---E--TX-XE-XToB?|oEXBEX-B?XXXToo--f
m-o--BB-?-?XX---BX?BEBE-M-?-XEXMoXB?o?--XoM?-XX--?XB?X--oMoX-X-??----o-MM?BE--XMoXM-?B-E-X----B?B?o-o-B?--?XXXB?Bo-oX-XBM-ooM?EBEMBBXoEE-B-|oX--BT--oMM?--T?X-EoB-TBTXM-X--o--B---MXoMXX|EXo-XM-?Mo-XEBX
X-XXXXXXXXXX-XXX-X-X-XX-X-XXX-XXXXXXXXXXX-X-XX-XXXX--X-X-XXXX-XXXXX-X-XX-XX-XXX--XXXX-XXXXX-XXXXXXXXXXXXXXXXX-XXXX-XXXXXXXXXX-XXXXX-X-X-X-XXX-XXXXXXXX--X-XXXXXXXX-XX-XXXXXX-XXXXX--XXXX--XX-XXXXXXXXXXX
