-----?B---------M------?-------------X----------------------oB---XB----------------------oB---------?--?----------------------------M-------------?B--------------------M---o-----------o----o----Mo----
----?-------X---o--o---E---E---BE------------------------------E------o----E----------X--X--M--?-----M-o--------------------o----M------------------X--------------------X-o-B---------B------------?---
--?--E-----?---X-------o---------------------------?-----X------------------XX--------------oE-E------XX------o----B-------?---------X-?----M--?------o------------------------------o----o--B--?----?--
----?----------------X----------------------M-----B-----------B--?--o---M-------------X-----------------E------Bo----o--X--------o--------oB-------------------M--E---------------------o-X-M----?------
-----?----------oX------------o------------o-B-----------EX----X----Mo--X------o--BMX--------X-------------o------?-----?o-------o--------?-------MB----M-------o---X------o------M-M--o-o---B----------
---X-----------------------M-------oBM-----X---o-----------X?X-----?-------o---------o----------M-----------o------------??-------------?----------------o-o---------B-----o---Bo--E?--------B-----o----
--------------o?----------------X-----M---------o--------M--------M--------------------M-M-----o----?---B-XM----X---?-----X------------------B?--o-------------------------------------------o----------
-----------o-----------B---X---B---------------o-----------------------------M-------------X-o-----------oX-M-----o-?-----o------B--------Xo-M---?-?----M--------o-o--E-X---o-----XXM----------------?-v
------------------------o-----------X--?---------------------------------X--------o--E-----------------?--------X-----------X-----------oX-----X---------------------?o-------o----?-----Xo--oB--------f
---B-?-----?---XX?-----------------o---M----M-----M---------X-X-?o----------E--------------M-B------M--E-Bo--------o---------X----------------------BX---------?--------------------X---M--------------f
----------------Xo--oXB------?------X-------Bo----------BX-----M--X------X------X----------------?-E-------B--B--EXXo--X------------o--E-------------------------------------------o---------o---------f
---------------o------------?-B------------------o------------?---B---------M-----------E--------?--M---o---E-------------X------o-------------------------------M---?-E----------------X-o-B---X------f
------------X--T-----o---Xo|B-oT-X-T---M----X-----T--TXT|--T--E-----E--BT--E--To----TE-TB----E-----B-B-T?T-T?----o--T-X--XT-o-ME-----E-X--?X-M|---Mo-----X-B|--XooXo-BMT-o--BX-?-B--XX-------E-T-o-o?--f
------M--?---T?--B|--X---B-oX?TX?-------XX--M---oXo-o--BT-------?-XT--?o---o---B-TB-XB-----To----------o??-----XX---X-TT----T--o-T-T-B-?--T-o-X-E-Xo?-----T--?o-o----o?--B--|B---oTB-MX--ToT--X-oEo-TX-f
m---------?--TT--X??----T-|-TTX-----?---o--E?--E-TET----X-XT--E--B---M------T-----o-----T-B?----?-M-B-----T??-oT------E------T-T----o----o---------BTTMB-|----ET-T--|o-TT--oT--B-TM-E--X--T|-B-----|oT-X
XXXXX-X----XX-XXX-XX-XXXXXX-XXXXXX-XXX--XXX--XXXXXXXXXXXXXXXXXXXXXXXXXXXXXX-XXXXXXXX-X-XX-X-XX-X-XXXX-XX-X-XX-X--XXXX--X-XXXXXXXXXXXXX-XXXX-XXXXXX--XXXX-XXXXX--X-XXXX-XXX-XXXXXXXXX-XXXXXXXX-XXX--XXX-X
