-o|-X--------?---To|----E---?--o-|----X------X---T--BT-X-E---M---B---------o---T---|T-?--M---E----B-o-B--B--E--T--??X-M------o-----E-M---o------MB-?-------B--T---ET----BM-o-T-?----|---|----------EEB-T
-----ET-?X-E--o-o|--------o?---X-o-|?BX?-T--|---------|-o--M|--?----------------oTT---B-o-|--E-E|Xo--X------------EB--E--EXo--o--X-X--T-T--X---ET-oBM-oME-B--E-M-------X|-T|-?-oX--E-X|--o------T----M--
---B|----Eo-TXEX----M---o--------------X---B----XX--X----|X--|--------o-----BT|-?-----T-?M-|--|?-----|---o--?-???--BTM-X-T----T--M--BM---B---E?|--M----------E-oB-M-?-|--|--B|-o-----o--E--E-M----o-?T--
---E-|--o---oEEB-T-TT-B-?MXT---BM--|---|-----X-TB-Bo-?X?-|E-Bo-T----?X-----?--|XX--?--MTo-B-TTo-MEM----BB|--?-|-|?o-?--|--X---?------o-----------|?-XB------T|--T---|----|-TB--o--|XE--Mo------X--------
-B-M-----E--M--|---M-----B--BMB--?-MM---------|-ET----T--X?-----|--MEE--o-------X--------M-TE---|?M-X--o--B-||-TMo--------------|X---M--T--o-oBE----o------|---M-E-|o--o-o--To---X-X?---|--?-?-To-B-X---
--------E---T---B--M-----oMM-|--E----------|---M----|-X----BE----M|E-XM-----?----o---o--oT-M-?--M-|--T-oo----|------------T--M-?-------EoE--E-|o-?-------X-B-M--E--o--|-|------EX---oo---X-|E-?------BXE
-o------M---T---MM---?--B-------TE----M--XE-----X--------------EX?---B-----B--E--|---B?-M-?M---|--X---X---X--o|o-X---B?o-EE--T?E--B----X-o-TM---TT-----X-B--T-------?--?-BT-??-|--E-MMM----M|o--oB-o---X
-T--o--?---XE---TMXo---------B?----B|-E--TT--X---E-MT---X---E-EB-o-|--M-o-MT--M-T--|------o----?-EE----|--E---TB-o-------|--T|o-?-XM-B-----|-T---------T-?---B-------BE-o--BM--?-----?--B------TM?----X-
-M|-----ME----T---|TT---B-B------o-----oM|Bo|-X---T-----o-MBX-TEM||-?-T----|--oEXE---BB--B-BT----|?TX--o-oT---T?--X-?--M-MT?--MT--B--|--MM-E--X---|-M----oB-XM--EB?-|--o---------EB--?BT----X-o---------
---o---|-E---X----------E--o---E-o--X|-----|Mo----|-------M-----o-----ooB-X--XB---T--------o-oEX----|--ETX-----T----?oET----|o--?X-o--?-----|-M|---To---E-M----?M--T---|M------------E?-o?--M--M--M-----
--M-MMoM|-----E-?------T--E--X----T----oB----B|-|M-T--X--X-X----|M--X----E---oT--M--o----T-|-BXX-BB-------TXM?-|-------E-B?-BE-XBT--||---|B--T--Mo?-X--TX-X-E|------EE----X-|-ME-M-------BM-?X-----o---T
--T-|?B-E---To-----o--?X--MX--TMT---T-X--|---E---X--T-ooB-E-?-M---|-XT--M?M-|----B--------X------B-M-MoXB-|----------|---o?--o-T-----X---X--B--|------B------B----T--T-M--?-------X|-B----|-XM?TM---|---
----??T|-?-X-B-MX-E---?--BE-------T---------Mo--------XE-----B----|-M---B----|------X-M---E-T--B|-XX--B--?X-TM-|o--B|---X---E-T|E--T-B---T?o?-|-oXEX-ooEoo---M----T-X?E?--?-oB---MX--------X-M|-E--|----
-X-----o|M------?|-T?--T--T-X--?-T-E------M|-------oB-----M-E-MX|--|------ETT---------?X---E-BoEM--o--o-|---EE-X-|--------|X--BM--------------------------To-T--X-B--TM|E---BE----E----E---o-|---------E
-------?-X|--E-|To----X-E---T-B--|-T-|?---?-----B----X------E-B--|?-E-|TBT-?o---B---?--------T--?|E----?E-----|-EE---BX?o---o--?-|--------X---M--T-X--M-T-MB-??--|BT-E-BTo--T--o---o-ME--MB-------?-----
-XXXXXXXXXXXXXXXXXXXXXXXXXXXXXXXXXXXXXXXXXXXXXXXXXXXXXXXXXXXXXXXXXXXXXXXXXXXXXXXXXXXXXXXXXXXXXXXXXXXXXXXXXXXXXXXXXXXXXXXXXXXXXXXXXXXXXXXXXXXXXXXXXXXXXXXXXXXXXXXXXXXXXXXXXXXXXXXXXXXXXXXXXXXXXXXXXXXXXX-
