------------?E--------E-TT----------------M--XT-----Bo---B--------T--------T--TT------|-------T-----o--?M-TE?------o-------X-------o---------T--BM----B-?-B-M-o---------T--B----T------T--?-------------
---T---T-----------------M----E--o---------?---TX-----ET---T------------Xo-------X------X---oo-o?-o-----------------------B-XBo---BT?-----T--X----MXX--T---------T-----------------------To---o---------
------T---o--------T---|---------?-----B-E-------------------B-E---T-T-E-?-M-------TX--------T-----o-BMo---------T----T-------T----T----------------------o--------T--MT--|o-XT|-o----o-------o----|----
---------B-M-----|T-----B--------X--T------T-o----o-X----------------o---|X-----T------B--------M--?-E-----------T------?-M-o--o--?---X-----|--|--X?oET-----TT--?-----|-----o---------------------------
----T----------o--?----X--T---T?-----T--------E----------o----------------?----T---T-o--E-T-----X-T---o-------?----|---M?---E----------T-?---?------?--T|----------------E---|-B-----X-?-----XT-------?-
--T---B--E-------M----E---B---------------T-TX-o-?------?B------T--T----T--------------o------T?---o--X-------o---------------M--M---------T--o-------X--E----------X--TT-----M---------T-------?---T---
-----------------------|--T--T--E-----------------o----o---------?--------------B-----B----E-T----------ET--TMM---X----------X--T-?----TX-----------T-|X---------X---T-----oo-----X--------X-?----------
-----------------X-|o--|----X-o--------EM------To--X---?--X-------X-o---oMoo-------T?------T----M?---T---------X-----T----T--------T-X---X----?X----------------E---T-o-X----B-X--------?-M-----------ov
-o-X----------T----X--o-TT--T----T--------M------------X---?-------M--------------------oTo-------X--------?M------T-o--------------T-------To--X--------X--T------TX--X-?-----------------XE---------Tf
------T--o--T---BX-------E---oEo---------X----------XX--------|-----M-XT-T----X?----XX-----B----X--T-------o-------o------------?--------B-----------T-----?--X--o----------TT------------T-------o----f
-----B---------------------?--------T----------------B--B----X--?TM---?---X-o--X---E-------T---TBT----B-B-T----?----X-------------|-----E--o---------?-----------E--o-E--?-?-------M-------------------f
-----X--T---XT-T---o--------o--B------T-T---o-M?-o-----TTT---------X----XoX-oM--X----------EM----------------?-T-?X--X?--------------?--TE-?------oo--T-XE-M---EE-B--M----T--B---M-----------T-------B-f
---TTBBoB-TM-------X--B--TE-M----EX-M---------B-----o-T?X-|--T-BE---?T----?T--?---T------T------BX----?------M---T----X----T--T--XTo-X-|---B----M----XT-----X------T---T-------------?-------o--o--T-E-f
----EX--T-B-o-T-T--X------T--|M---X--?-----------?-----?--Mo-oo-X--TT----o-M-----?-------T-T-o--------|T-E--To--T-B--E---EEo-----T---M---E----|--TT--?-T-T--T|-----o------X--E-EX|------XT------T---?B|f
mX-XBX--X-T---X-X------X------|-T-ME-T---M--X---o----oX-?--o-X-o-T-X--TB---MX-----?--X-------X-T-B---X--|----T-----T|-E-EMT--TT-X----------B---Eo----X|-M-|T-T-Eo-------?----?X-B-?X-oB--M--X----------X
XXXXXXXXX-XXXXXXXXXXXX-XXXXX-XXX--XXXX--XXXXXX-X-XX-XXX--XX-XXXXX-XXXXX-XXXXXXX-X-XXXX-XXXXXXXXX--XXXXX--X-XXXXX--X-X-X-XXXXXX-XXX-XXX-XXX-XXXXX-XX-XXXXXX--X-XXX-XXXX-XX-XXX-XXXXXXX-X-XXXXXX-X--XX-X-X
