-|?--X------XM--------o-TE-B--|-B|--T---X-B--B-B|BEMBo---M------T----------------B-|MB-------M--|o-?T---E--------ToB---------EX--T--B--|EM-----?----?X-----?--B-X----o-------MBM-?B-----T-----------B---
----?-E----------|--X-o-o--------??-EX-T--EEXB-B--X----?------------|To----?-?-o-o-?T-E--TE-------|--?--M--E--------T--M-----T----o---oB-X-----BB--|--|------T----|----?------XB-X-B---Xo-------B--B-o--
------X--M-----o--X---E-----------o--o----o-B---|--B---BE?-Xo--M---?-B-----|oB-----T-X----E----------o-----X------Bo---o|M---?--o---o-X------E------EX---------o|--E--MM-----T----o----?------ToX---|M--
-------|---M----X----T------|-To-?T-------------------B--M|M?-E--T------E|-M--T-E---E--XXX---BX-|Eo--------|----MM-------B|----B--?---X-------E--------T--TE-|TM------E---B-----M|-o----?T----X---------
-X-----o-E-E--?---o-M------------o-To---?E----M|--o-B--------?--------?B-X-M--o-X----o----?---E-B-E---|---|--------?-?--M---M-------------o-T-----X------?---------o------X-XM-o-M-------|-EE---?-ME-|--
-X-------------M-B--|--M-----------MM--------Mo-?---------|o------------T-------?--M-------M---T-B|---------?---o-----E---X-----M-----M-M-E---?---E----B?----XT--------XX-------E----MB----MT--T----M---
-------o--o---------------M------B-Xo------?-E-----T---------X-------o---------E--|---X---oBo--?BoMTX-M-----X-?-o------B?------------B---T--?---M-M------o-TB----XT--M-|--------B--------o--------------
----X-B----??-----B--E-o|E-B---BX--E?-------Eo--M--?----------E------M----------EoET--|B--E-E----M--|B--E--X-?B-o--------?---------X--?-T--o--o-oo-XE-|-----------E--o------MX------B?-M-----------X-T-v
-----B-T-----o---o---B--MM---?--B-------|?EM--E-------|X----o-----?----?--|----ET--ME---B-----X------E--------oMoM--Mo---o----------TT-B-|----|?------------TE-|--X-o---?-M?--M-----B----TT-------o-?--f
--X--M|o-----M-ooM--|T-------X-------M--X-E------T--T-|--M-------B-----------M?--TE??E-|----?B-o---?|?-oo-------?---M--B--?|T-B--E-T----X-----MTE---------To?-E------|X|--o-ET-|---------|--?B-E----|--f
--|-TM-BM--?-|--T----?T-----X--o-B----?---E---E----E-|-o--|---|o-T-o-T--E-o--?---------XM--ET-X--------B--MM---?--------?-------X----------?---E-To--------o-?B-------B------BTX---?-M---oo---------o--f
---M--|--oB------TB-|--M-------B-M---B-----X-------?T--------------o----E-------T---X-|---M--|------------------o-------TB--X----T---B-----T----------X-?oo--------M------E---|T-T----X----?-o----|-XETf
-X--|----E----|--E--|E-|---X---X---M--------o---------BM----------X---X-------M--T-----??--M--------B-TT----B-----o?--X--|TEo----------o-E|-M-------MB---|---------|---------E--?------------BX-----M--f
-T-M--B------T-------?---X-?E----E-|----TB--TM--?o-o-X-----M--|T---|--------TXM-------|---------------------TM---XB-----|--E-?---M--|X-----E--T--M-------------E---B|---------------XBT-----M-----B?--?f
mM----------EXE----|-o-T---------o----|TB-M---M--|B-------------E|-|-----B--------M------E-?X-o--B---B?|--------T--?------o-o?--|-----EMM-o--Bo-o-----|M--T---X---o--T--o-E-M----------T------T---o--E?X
XXXXXXXXXXXXXXXXXXXXXXX--XXXX-X-XXXXX-XXXXXX-XXX-X--XXXXXXXXXX--XXXXXX-XXXXXX-XXXXXXXXXX-XX-XXXX-XXX-XXXX-XXXXX-XXXX-XXXXXXXX-X-XXXXXXXXXXXXXXXXX-XXXXXXXXXXXXXXXXXXXXXXXXXXXXXX-XXXXX-XXX-XXXXXXXXX-XXX
