-?XB--------X------------------T----------o-----X---?-------X----------M?----X---------?--------BB----------E----B---BB-E-------B----X-------X--------B-------o-E-----|-------M-X----|-|----B-----------
---oE-X-------o---o|o--XX------T--?E-----B-|E---B-----o----BE--M--------------------------------?BM----o--B--------------------?-----------------E--------E-E---------------------M---M-------------To--
---?--|---X---o-----B--XB-----E|----B----------M-o----|----X-----?-B---B--X----------E-----T--------B-----------E--?--o--X--B---B--?--o--X-----------X-------|-------M--|B------?------------M-------M--
-E-----------B----o-------MB-B-B-MB-B-----|--M-----------o--B-B-o---M---o--------X-E---------------B------?-M------E----EX--?-----o?-M------Eo-------?--?-X-E-o-oXo--X----?-------|--?--o----o--o-------
----X--------o-o-------?X--X--------?---o----B----------oBM---X----B---B?---B-------|----?-------|---------------------------X----------BX---B-X---------o-----X--------------X-?---------BB-B-B--------
---------B------B-----M--------?-----------B-------BX-------??-?-----Xo-----------|---E----X-----oE------Xo-T--------B---------T--X?---------------X--------E------XM-------o?---X---??-----o---o----oB-
-----BE--?---------B------?M-----M---------------------------M----------?--B-B--B--||------------X?-o----------T-----M--X-----o-----oo---------------|o?-B-------oX-E------B------------B-o-X-BB--------
-BT--------MX?---------o----oB----------M-T-o-X------?--?------X-----X---E|--X-o--E------o---------T--------------------o-|-X----------------------------|------M-----X-----------|----X--X--B------|--v
-T--------------E?-----T-----X----?-E-------T--E----X-B---o-X-----EX------M------o-BoM|--o-o----------E-----Xo-----T-----BB-----------M--B-X---B--------X----oM---------------B---------o---------B----f
-----------------B---------------------E--------------B--------------X-------------B-----------------T--------X-T-----------TT---E----------X---------o----X--------------B-B-----E--------------------f
---------?-M-----X--o-----?------------?-------------------?E--B-----T---XB----------BM?-----------------B-----------------------------------X---B---------?----T--M-----T--o-----------------?---X--?-f
---o--------------M---M-----|---E-------------X--------------X--------X-M-------X----T-B--M|---M---------------B---oB--M--B----?----------------------------------X---------------M---M--X---o---T-X---f
------B------------------------T-------------------M-----------B?-----M--BB--X----B---B---------M------------EE-------B-------------?o------o---M---Mo---------------X------T-----|-X-----------o------f
-------EB------X---B------X------?---------M------?--X---------------------------o------X----?---------o--------?o------o------Bo--o---Mo----M-B-o--------X----X------------------X------?X--|Mo-------f
m---?-------X----B------------o?------M--M---------E------------------?----|-------------------B-------X-M------o---EE------X----M-T?E----M--?---?--------------|------B-----------o-|-----o----X---?-oX
XXX-XXXXXXXXXX-XXXXXXXXXXX-XX-XXXX-XXX-XXXXXX-XXXXXXX-XXXXXX-X-XXXX-X-XXXXXXXXXXXXX-XXXXXXXXXXXX-XXXXXXXXXXXX-XXXXXX--XXXXXXX-X-XX--XXXXX-XXXXXX-XXX-XXXXXXXXXXXXXX-XXXXXX-XXXXXXXXXXXXXXXXX--XXXXX-X-XX
