-To----oX--TBo?Mo--X|--?B--BMX-TT-TBE-XX-B-BE|T-X??T----EE?T-X-X---TBT-B-M---oo-?o---MoMMT?EB--TX-T-?To--oT-M-T-XTXoTXT|ooBBETTBToT--??------BX-?o-TTME|XT---o-M--Eo|TBE-|-ToTTX--oB-E--ET----TE---B-B--
-TTX-?--o??o|TT-XTX-Boo?oX----XE-T|TTM|--BXX?BXEMTo-TXET-TXBXBX--X-BEX--X?-M?X-|-TX---B?EE|o-?-?-X-TTB--|?TXET-?-o?B|B-TXB-T-TTo-EX-?-?EET-TBBX--TT--B?o-TTB?-T|XEET?oT-B-T-EToB-?E-EB-o-X-|oo-X-T-TT-B-
--o?-XT---T-T--oo-MT?oTT?-----E-|ToT?oETXXXTTTToEoEX-MoT-?--Bo--X?T--BTX--To-o---|-|-B??X-TToX---M--T-X---o-TX--?TX?o-T?M-o|--?EBBB--oTM-XBo-------X-oXTX-?--o--BT-XBoTT-T---o|o|--M----EBoTXXMo-|oTEoM-
-o-B-EE|-B-o--TTTBX?--XTMTT---|XBEBTT-?oX-BT-BMTB?T--T-B-TM-BTE-M?BoEEBXB-M?TM-M---oEB-EM--X--BT-TXTooB--B-BMMo--X-X-BTMTTX----TTX---ToT-X-T-T|--EE---T--?B--X-XEMTTXBX-M-T?-XETTo-o?|o-?BT---oTMTTBMTE-
-M--XX-T---Bo--oE-BTBT-XBT|BooBMXoTETM|T--BB--|--B-?TX-TTX--T---|XT-XoBX---BETEoBoTTTo?T?X-E|X--oXE-E--?M|o-?BTBBX-M--To|oM--Eo-B?X?XEXoXXToX--oEM-MoTXEBTTooB-BTB-BTo-X--TME-BT|T?o|o-oBE|XT--?|-T--BX-
--------E??XTE?M?--oo?ETE-TXT-T----M?MXT--T---XET?E-oX-T-|BT-ET-X--XT-E-TTE?To?|-|XT--|TT---ET-X-TXEMXTM-B-EXTMB-?BX-o???M??--ET-BX-X--o?-MTo-Xo-Moo-MT?|-To?ToT-X|XXoBo-T-TTX||-TT---B|T----To-o--?T-T-
-TBTM-XX---T?XB-T--oXXTTMXXT---X---X--oX-T-TToEoM-MXBo-XMoXEMXTo-XoT-o-TE-TTMoX-?-ETooBXT-----E-TTMTTT|-B-o--oT-XT-T?XMoX-XT-X-o-T-||XT-XB--ToMT?-XTE-X-?TE-T---X--X|??M-?-XEE|o--|-BTEooT?-?oX-o-o-----
-XM?X-BXT-X|-BB?BB-o?-oo---XEMooETTTXETEoB-EoXMMETMoXT-XXMM-oT--T--To?EE-X?BTB--B?M-oBoM--?B?MMT-o-|TX--EToB|-M-o--o-T--?T?---X-MXo-TTTMTTBoT?MoX-BooT-?-TB--TBT-E-?-TTEo?T?T-X-B---BE-T--?--M-TT-EoT-Bv
-ToBX|?-B-oT-X-oo?--X-ETTE-oEEX-ET-o--oTT-?M?oTB-|XXT----Eo-TEB--T--MTTBBT--TX--?--To---X-EE-X-B-?-oT-B-TBMEMBo-|--o--T-?-BXB|ooTB?EE-X?oTXEE?EXXEM--XT-?XX-XooET-TToTXo-?-M-T-M-TX-M-E-oM|---XBBX|?-?Bf
--EE-?-MMT?-oMoE---X|T-EMT-EoXTBM--B-MBT-XM-XTo--?EXT?|oX---TT-TT-XTT?T-MBTMToTME-?-T-|o--XBTTETBEXT-oX--TT|TT-TTM-XTBoBo-T?T-T-?TTBX-To--?BB?BM---MTXM-oo--XoB--oBTB--X--T?---o--M|-B?T-||-TTTX--X---Xf
-MTXBMTBTT-o--TM?oX?|MTXTX-o-TT-B-ToEE-ETToX--B--T--??XE--?-BoTM----B--X?MT-TXM-TTBooo|XEX-T-E-EXB--TX--TT?X|XT?-X?X|o----T-TXo--oE--oXo--E-XMETBMTBTBB?XTXMoTXX--X-ToM---TTMoo?-??Mo?MTTT-XETooTE-T-T-f
-?T---TT-MET?oXEX-T--T-o----X-MTToT?EX?MT-|-BM-o-XE-o-o--ETX?T-TTT?--oo-EoooTo-X-MToMBTTXB-XXX-T-TT--TE-B--oXTE-XX-?-oo-X-ET--Eo-T-T---oEX?-X-XoTX---TooXTX|TT--M-E-EBT-TXTTB-E-M--TXBT-o-T-TXX-?|-MMEof
-B--BoEoBoX??M-MoBoX-BEB-E-XE?-?X?--B-BBM-o-B-MMXXXB-EoBEXXXXX?B---B?EX----BB-B--?XX-?oXooX?EE-?-o-?ToXMoXo----X?-BX??M-B?---?XXBM-?|BB-oMoX-?o--???--?BX-XX-X|XoEMMX?EXMoX-|-B-B?-B?-B?-B-XoB?-MoB--?Xf
---B-BXBMoXB-BXXMB?-Boo-XM-BEXMMB|-M-?-X--BBooB?E-oXBX?B-B?oBX?-ooB?--?oE--XEB-TXB-?oB-?-oB--BXEBo-BEX-XMXM-MXBX-o-BT------oB?M--??XXXXXB|oT---E?-?X-?-??MBX-EX-XB---TB-oBoBXBoXM---MX-BBoTo-E--B?o|-oof
mB--?|oMM?BBBEE-TBo-E-oo-XMEB-oE-XM-M-EB---M??--?-XXB-EB?-XT?EBE-XX-BMEBXE-?oo-?BX?BMB---?BEoXBXMXMBB?M--o-?-oo--MEBXMMB?EoX-?-X-?BBXMoo-B--XM-E-??B-X-B---MX---T-XMo-BBoX?-EX??BoEB--B--BXBXM?B-X?T-|-X
X-XXXX--XXXXXXXXX-XXXXXXXX-XXXXXX-XX-XX-XXXXX-XX-X-X-XXXXXXXXX-XXXXXX--XXX-X-X-XXX-XXXX-X-XXXXXXXXXX-XX---XXXXX-XXX-X---XXXX-XXX-X-XXX-X-X-X-XX-XX--XXXXXXX-X-XXXXX-XXXX-X-X-XXX-X-X-XX-XXX-XXXXXXXX-XXX
