----------?-----------------?------------------X------------------o--X---------------------?--o-o--o------------M------X----------B----------------------------o----------------------------------------
-----B--------B------------M-------E----------XBB-------------?-B--------B-E----------------X-----------B--------o-------M-X-o------?---B-BE-------------o-----X-----?-----E-------------------------B--
-------B----E-oMX--o--o--------------o---M--X--B-?--------X-----?o-----X-E----X------X---B-------?----------oX?---E--B---------oX------X-?--o-------X----o-E------------------------------------?B-X----
-------------X-E---------?-----Xo--------E------X--X------------X-----E------o------B------X-----------o----o-------o-B--?-XE--------------------o?---o-E--?-----------------B-----X--------M-?o-X-E?---
-------E--------o-o----?------------------X-B--------E---------------------------X---------------E----------XX----------------X---Mo---------E------?Bo---------------------o----oXE--------------------
--------o--------X------E-------------------Eo---o--?----B---X---B-X-E--------M-X--------E-----?--------B-------------------?--X--o---oB---B---------X-------E-------?----------B----X---------B--------
----BM-----B-?----------?----M-------B--------------o------------o-------------------M---M------------X---------o--o--X----------------------------X---------X-------X-----------M---?---------X--------
--EX------M-----ME-----X--------------o--------------------?------o-EB-------------?M----------?---o----B-E----------------------XM--X-BE-X----------B------o-----X---?---X-M-?-----?--X---------X--X--v
-Xo-M------o----X----------X------X----------M-----Bo----------------------X--?-------------X-------------------E-o--------o---X--------------------X----E--X--o----------?-------M---E-----X----------f
--?----------B----------X--E-------B----------X?--------X-B-X-----B--------o-------M---X--------B------X-B---------------B-----------XM-E--------o----o----E------------------------B-------o-----o---Ef
-------------Eoo--M--------------MX---------?E----oX---?----B--B-----o--X--------B?-------------------------ME---------E---B-----------------------X-----------?----------------M--------M-------------f
--------B-------------o-B------------------X------------X------B---X----B-E----X---B-------------------------------X--E-E--------X------------------B---------------o-----o----------X--X---------oo---f
------o-o----M--XX--B-XT-T?MXXT-T-XMo-XTo--T|o?-------?-XT-----To-T-T---|-X-o-?---BMB---X-M?TE---B--?---E-----?-E|--Xo------||-o---------X--XX?M-|-E---T--?o-oX----|---X-oTXE--TT--T-----B--oMoTB-----Tf
------|TB||-B-X----|---|o--Bo------B|T---|--|------o-|X------E--|-|---|||T|--T-X--E|B-|--|-------EE|E--?-E--T---|-X---|--|-T||||--||-T-|E---------|--|-|--|-||--|--M?oT--T-|-ET--XT|--|||-E--|------T-|f
m------|-|-|T-||T---|TT|TE-----T---B-o-----o-|XT|--E-|--|E--X|||-------TE|T-M-|-T-----|TM--E|---|||--|-T--||-|---||-XX---|T-o|-E-||-----X-T|-T------?|--M-|--|XT-|----|----|||||--|-||-T?TB-|---|T---|EX
XXXXXXXXXXXXXXXXXXXXX--XXXXXXXX-X--XXX-XX-XXXX-XXX-XXXX-X-XXXXXXX-XXXX-X-XXXXXX-XX-XXXX---XXXXXXXXXXXXXXX-XXX-XXXXX-XXXX-XXX-XXX-XXXXX--XXXXXXXX----X-XXXXXXXXXXXXX-XXXXXXX-XXX-X--X-XX-X-XXXXXXX---X--X
