----X-?oT--X--?-----XT?------o----B--T-X---------B--T-oT-o--T---o-----------T-?-T-T--E-?---------?-ETo--|--X---X-------?---T-----EX?-----B---??oo-B-----TX--T----T--B---E---?-XBT-?----o---|--------TE--
----T-T--oT--TX---------M---B------XB-----E-------XT-X-B-T---B---|------?-----?---oM-----T------TB--o--X----T----E-------o------B-E----XT-------?TT----T-----To--------T--o-----------T-X----XT-----|-o-
--T-X?-?-T?o?--B----T-X--oBT--?------------X--T--o-M--E-----------TM--XT---?--T-T-?----o-XEBo---B----?------E-------ET-M--TM-E-o------M-----E---B-EB---T-----o----|----T-?----------?B-------------X-?--
---------?--?--T-TT--EXo-----X?T---TMT----------T--T-EMTTTT--T----oX|o-To----B-XoE---------B---B-TB--TB--o---XE-T-----o-MTB-----E------------T?-o-|-X---X---E-XX-XT-XB-X--E-o--o|o?-E---B---------------
----------T|-|--------X------|M------E-Xo----B----BE-------T-T----E---o-B-E----BB--M-T---X---o---oT|-?----?--E-B-TX--T---o---T------X---E---------TT|-o-BMT-Xo-E-----T?---?-T---T---TMX-----M-o?oE--X-T-
--T-B-----B---o-TT---T-M-Bo-M-E---?---o-X-------?---E---o---E-------oX---------------X-----X--oo---X----T--?--T--To---BT---T--T----T|B-T--M?-T-------X----M-X-o---TBo----Moo---?T-M--o------T------X----
--|-BMM---------------ME--o----|--TB-E---?M-------|-T----o-M-MTT------oX---T-----TXX--T-M-TTo-X-T----T-B----M-T----M--T--------T----?----------B-B---T-E-o-T-o-----------------T-X---------o-------|-||-
-----BT---T---oX----o-----oT---------T-o---------MT-T-----MET-BT-----o-BX-T-?---B---TBX----M-----------TT---XM-?--oT--------M-T--T------B----T------oo--------?X---?-------BBT-B-------M----E-T--o|--T-v
-----|-o-M-----------o------o---BMT-T---?E?---T---?-----XE----T------o----T-X--Xo-?X---|XX-XT---T--------X-M-|B-B--o--M---E-T--E----o--T-T-------T---EM-XTMT-------X-----T-oT?---XE---BBMX-----?o--E---f
-T------MXB-X?---------X----?---------M------?------M-T---TM-o----?-------M?-M-o-|---------o---BoT-M---T-o--T--T?--oE----T------ToT-T-?T-----o------o-----oMo--E------------o-B-M---TM-X-----------T---f
----XX----o----o-T---o-TB-----------T-X----o--------M---T-o-TB-?-----Xo-------?-M---------X-M-TT?TB--?T--XX---BME-|---------o?-XB-X----T-TT--?-T--M-----oo--o--M-o--------T--X------T--T---X--TT-T-----f
-------XT------------------------------------?----------X----------o--X?T-T-?----ToTo----------T-------X?--T----------T----T--TMT--ET--oT-------T-T-E-----T-------o----------|-?-----------MM---EB-X-?Tf
-|o-M-XB-?---o?|o-XB-Xo-BBMTEXXMBM-BB-ME?--XX?-|?-M-XMB-EX-B-??E-EBXBM-XoXB|B-XBBXM?B-MXX--X-o?-Mo--X-Mo---o-BB|-B?XBo--X-??ooX--B?-oMBooB-oB-XoMX?BoBX----??M?X-?oo-oM-T-T--MBMMB-oMB-X?-B?--B?o???Boof
-XMM--MB---o-BoXXBoBXBo?oM--BBoX-XXo-o-B|X-B?BXB-oX?-?-o?EX--EMXX-X-MEo-|B-o--BB?MXXX?MXMX-o-B-B-X-o-BXXX-X?BXMEB?M?MX?M?-?-TMXB-XM-o-o-EBX?B-o-B-oB-XBB?XoX--BB-MXB-ME-oXBE??-B-BXMX--o-??XX|E-XXo-?B-f
mB-B-MooB-TX--X-MEE|X--Xo--BoBB?XM?Bo?B?BEB-M-?XXo-EM---B-X----?-MB-o-XoX--X-?BE-M?X---XXM-MB-M-MoX-MX-o-o--X??-EXX--EMX-M?Eo-M?BX-??X-XXB--BXo?BB-----oBo?o-o|E-M-BM?MMX-?-XE?BX--XB|TXX-XEXBo--oMB?BMX
XXXXXX-XXX--XXXX--XXX-XXXXXX-XXX-XXXXXX-XXXXXX-XXX-X-XXXXXX-XXXXX-XX-XXXXXX-X-X--XXXXX-XXXXXXXXXXXX-XX--XXXXX-XX-XXXXXXXXXXXX-XXXXX--XXXXXXXX-X--XXXXXXXXXXXX-XXXX-XXXXXXX--XXXXX-XX-XXXXX--XX-X----XX-X
