-?----?E---X-?X---?----|--MX---B---oBo?--B-M----o--o?-?--M----------o----B?----?T--o?--o-X-T--XM-E-X--EE---?---o----ME---?--BB?MToX--X--BX---Eo-M-oB-B?-?--MM--X----XX?--------------B---oB?---o-EX-B---
-BX--?---------M-?X---------o-------B--B--------Eo?--------o--o---T-B----X?-E----o-XM-Eo---E-BMXBToo---Eo-XB---EE-?-X--?B--B-MXoX---?-?X-B?-o--B------M-BBM-oo------X--M--E?X-|-E?------Xoo-XX--BM-XB---
--?XE-?XE|BXo-X--?TXBB-B-----B-X--M-XoBX-XM--?-E------?---TBB-BX---o--X--B--Bo----EX--B-B-?X-----oE-oB----X----------?----B-X?o-?-----?o----?--X---o---MB--B-M--E---E--E-o----?-?---B----MB----X---XMo--
--XM--BB-------MBM--XX---o-o--B-B?-----B----M---?-B-o-MX-Bo-X-----E--oM-----B------------X--X-----X-Xo----B--X-?--M--B--M-----o----B--B------XX--BXXX--o--BBB-MB-X--BMBB--B-?--X---o-E------ME-B-----B--
-B-M------B--?M-----?---------M--?-B--X--|----?X-o-XBT?-?-M---M-B-----E?----MoE---oB-?----?-B---oBX-???B----MBBo-o---M---------TT-?o-----?--B-B----o----MB-B---------BX--X------?-B-X?----EoX---X-o--o--
--M-E-B--X--------?----E-?B-B---XM-----Boo-E---??B-EB--X---B--??----B-------o??B-T---T--o--?|---|TX---B---EX---X--B-X---Eo--?------o-o--------BE--|X-E---X---o-----?X-?T-BB------X-E--XBXM-E--X|--oBo---
-?-----|---?-?---?--M?-?-E-o-|-oB-X--?Bo-?-|-B------?--M--oB?--X---?E-X-B-BB-X--?X---XE-------?-B?--B?-o-B---?-B----M-X--?--E---TB------X-B----T------ToX-MB-----||XT-X?--?--M--------T-X-------?-?--oB-
----o-E---BX-B--B-------|-o----o-B?BX-B-----??o-?--M----?X-?oEBBM---?----B-o---o-----B----M--------X--?-X----ME---XEXM--B-X-----------o-B--X-----X-------o-|----X---B------M-?----X-o--M---B---X-----o?v
-MoX?---oX-|X--X-X-B----EE-?-E-Xo-B---M-X--M-M-oX?---o---o--?--X-XooE-?-----oBo------oB-BE-|---o---B-------X-o----|-BX--?-XX-X-X---B--oB-E------BE-B?-?----To-----XXX-?o--------E-------oXBX-?T-X-----of
-X----------E----T--?---BM--o---X--M---B---?-o-BE-?-M---X-------EEB-E-----?----?--oX--o--?--?----X--?---TX----------o-X---X--o-B--EXE-?X?--o?M---EXE?------?-X---M-B-----o--M?BXB-B-X?X--X-----??BX---Bf
--M--X--B?M-E-----?-?X--B?-|XB--oEo------M----EE---B---?----------B-o?----X-oX-E--E?oB--o--E?---B-------XX---B--------X-------EXX-M--?------o-E-o--E-M--X-------EM-------?---X------?-o-Xo--Eo----o---Ef
---X---?----E-B---X-B-XX--?M---B---oX-?-o--X-?EoX--T-?-oM---X-X-X-M-o???X---EX-B?--M-------E--BB-Eo--BXB--o-B--o-----B-B-?B---Eo-B---B----o-??-o-------Xo?BX-------M----X---M--??|--X-B-E---o-----o--MTf
---M-E-X--XM----X-o-E------M--o-B-oX------BT-------?EXXo---?-E-----?BB--X---|M-?--?-?-MX-B--XM-o---B---?--BM---M-----X---?--oX-X-o--XB--X-T|E-B?B------------T-----E--------XE-----E-?-?-XB----|B----X-f
---B-o----E--o---------XEoXo-------X--o-B-----BB------o--------E-X-o-Xo-oX-B-----oo---o?-E-o----?oM--o-----X-o--X?--?-------B----------B|B-X-MB?----E|X----EMo---?-oX-XE-----T-?o-XB---------XB--?-X---f
mo---Xo------B-----o|B------?--?---o-o-----X---oE-XMM-X-o---B------E---------o?------EEEX------o-B--------------------XBBE--E-----------M--X--XMXX---X--o-----Mo-X------?-X---EX-B--o----MXT--?|?X-B--?X
XXXXXXX-XXXX-XXXXXXXXXXXX-X-XXXXXXXXXX-XXXX-XXXXXXXXXXX-XXXXXXXXXXXXXXXXXXXXXXXXXXXXXXXXXXXXXXXXXXXXX-XXX-XXXX-XXXXXXX-XXX-XXXXX-XXXXXXXXXXX-XXXXX-XXXXXXXXXXXXXXXXXXXXXXXXXX-XXXX-XXXXXXX-XXXXXX-XXXXXX
