----?-----M---------B--E---E----o---o?X--B-----M-B-------o----BB------------------?----------------Xo--BX-----X-----??--B-------------o---------X-----E---------------------X-?--X----------------E-----
---XX-------------M---X----?-M-------o------o--------?-----------X---oE--M-------?-----E-------E-----?------o------o-------------?------------o-?--------o----------E--EX-----E---------o---------------
-------o---EM-M--------------BE-o-----------------------------------X-o----o--------XE--B---o-------E------?X---X--------o--------o----B--------------o---X?------------------------------?---?-o-------
-MX----------X---o-M--oX------B-o-E--?------------------M--------B?-----------------------------X-------X-X-------------------------E-------------------------------?M--o----o----B-o-----M---oM--X-----
---?M--M---o--B----M-------X------?-o---X---M----------E-------o--M-----B--?----?-B-X----------BX-o-------M---M--Eoo-?-------------------B------o-----------|-------M----------E-----o--?----o------X---
-----X---------------------------X-------X-----------?--X----oX-----------X--E---------X-------M---B-------------X--|---XM---o----------X-------B---M----B--|-------MoM--------oo-?-o?----XB-X----------
--M--|-?E-B---X--------X---X---o--?------?-?----B----B----X?-----?---o----o--X-------M----------------?-?-----------|X-o-X--E--M-------------------------o--|-------??----?----------------Mo-B---------
-----|---------X?---E-------X------B-------------------------o--------?-----X------E-X-o-M--------o----MB----o------|||-M-MX-------?-------o-?----------oE-----------ME-------E--------B---------E-----v
---o-|----o----X----o--M------------X--E------?-?-------E---------X----------B-MEM--Xo-----------------X--E--------X-||o----o--XE--X------M--|-----X--X----------B-M--------------------X?-------------f
-------o-----------o-----XX---------o------o---EMX------------B--?---------X--X-------M--o-----|---??-X-------|---E--||----XE-----?M---M--?--|-----------X---X------------------------o--------?-------f
--B--|---------------------M----B------MB--XX--XM------------B--o---------B--------X-M----?-o--|--------------|-o-o--||E---------------------|B----------------------------------X--B-?---o------------f
-M-----E----------o------------?-X----X-----o--B----M---------------X------o-----------M-X-----|---B-----------------||----------E-o--B------|?-Mo--------------------?-E-----?----E----M--------------f
--------X-o--T----T-B--MX-T-M--T------MT--TXX-|-----o-|X--E--M---XB-M?B-o-TX-T---TT-T|-T?BTM?-----o-?T-TTo-------?---|-TE--X--MT-?-X----|?M--E----------------o-----|----------oT----------o--MT-X--T--f
------X-E--?-|---|o--|-Eo-||E--|---??--|--|M|-|-E-E|--|---||---||-E-----E-|---|--||T-|?|-------E---|---||------T-----|-|-|o|---|-|-----?|------B-|o|-?-X------|-o---|-----------|---E--|-M-----B|-TE--|f
m------?|----E-------|?--E||--|--------|?||-|-|E--B|X-|---|-|E-||----T---T||--|B-T|B-|-|-o-----|---|-|-||------|-M----||-|-|--||-|-oo----E--E-|--|-|-T-o|-o--X||----|--T---XXX--|?---E-|||-B|---||-|--|X
XXXXXX-XXX-XXXXX-XXXXX-XXX-XX-XXXXXXXXX-X-XXXXXXXXXXXXXXXXXXXXXXX-XXXXXXXX--XXXXXX-XXX-XXXXX-XXXXXX-XXX-X-XXXX-XX--XX-XXXXXXX-XX-XXXXX-X--XXX-XXXXXXXXXX---XXXXX-XXX-XXXXXXXXXXXX-XXXXXXXX-XXXXXXXXXXX-X
