-o--E|T-X-|X-XBX----T|o--oM?TE-TTT---XM---MEo-TM-|-TETXX-T---|TE--TTT--T--XXT?|-E|||BTTT-XEBT-|-TT?EXo---??--XTE-TX-XB-ETTTXXXE|ooMX---?XTB-?--?-XXooTT-XXoTTT-EoTT?XoT--?--oX-T---TX---B--E-M|B-X-o|oB-
-BoXB-XX---TT?----TBM?TM-E--X-ooToo-XoBT?T|X?XBTTT--XMETME---BoM?TXTT-E-XMBMMXM---T-B|TXEM-?T--|T?oM--BTEEX--B-----XoT|BT---|T--?T-M-oXTT-?BXBo-oM--o?B-BX--T?-TM-Xo---TBTMM-XXB-TT|--BEoX-----EX-XBTT?-
-T-|X??oET-oB---?T--XB--ME-ToT-ET--E-oTB--X??T-E?---MoX--ETT?-o|-E-|B-MTT--B-oT----B-|TBET----ToTXo-XX-oE?-XT--MBoToBTEXTXX-|TMT-T-----X-XT?T-?T-MBoT|-ET|oETBT---?To-XX--MXBT-BX-T-X--XXTTT-EB-|E-|-X?-
-XTooEXoTB?TBo---ToXXXTX??-ToBo?oTTEE?---T?XT?TXXM-EM--oo--TM-B--XT-X-BXT-?|?---|-BMoEo-?TM---TM?-?--?-?o--XTT---?BXo?TTXME-T-TX-o-EEo-X?-oo-BBXooTXoT-X--M-T-oT--|-oT--?E-M?X-BM|-XooTEEoXTo-|-BX-o----
-E-TXB?---ETTXo|B-To??TX--TTM---oET----o|TTEo--M--X-EE-XTX-T-XooBTTT-X-TTE-|-BXBooT?-TToo-oo-ToBBBTo-TT-oBMX-o|-o-T?TTE--T---T--TTTTE-TB-TToXBE-B-TEToB?|--M?--T-X-----E---T-?-TTBXX-o-T---?-----M-X-?--
-M-|--ETo-o-o-oo?--B-T-T?--E----XTXETE-X-X-XE---oXXTX?-TToX-ToB?TTMoToX-Xo--T-T-o--Mo-ooTMoTM-T-?|-o--X?T-TT?T-B----o-oB-TToTXXoX---TXo----oT-T-XX-oM-MoB-ToTT-E-o-T-|EBT--X|-?-TToB?B-----TTX-BToT---T-
--TB-BBT-oXEBB---T-M-X--XMoTTXToEEB-M----o-T---TTB--XB?--?T?-M-BoT-XT?B-TXo----To-ET--?X-|EoEE--X|B----?-E|T-o--o-??-?-TBTX--BXoXMMBoEE-B?-XB-?T----XX?-??To-o---X-XoBX-XTo-|-?oBTo----M-oBXo-X-----ToX-
-T|----T|oB-ToTXX-MX|BX-BX--?-o?-BTT-XTBo?--T-|EXB?--oTT-----XTE?-?-X-B--T??T?o--B?B-oX?-?-X-oT-T?o--XT-?oTTX---TEXo|--?TT|-?M-|TBX--o|XETE-T----MX-B-X----BoXEB-?B--M-||o-?EXoB--Xo-oTTo|o--TX-ET-oE-Xv
-TTToo?BTE?-E|TTXo-X-TXX--X?--B-XooX--M-T-oXT--T-T-BX----|T-o-o-TXXE--oT-TB?B-|-oX?oETM---?--BT---------T-oX-TTo--EX-To-?o-XMX-XT-BXTX---T-T?TXTT-MTX-|TBTBX?EMX?-BToT???-?---XX-XoMXXT--X-XEoE-XX-BBT?f
-M----o--T-XTX|X|?-B-E--B-XT?-oMTX-EXo--Bo-BXTX|XTX--XMT-?TTB-?--X--oTX--T--X-X-TXT-X-T---TX-|T-oM|TBX-o---??-E?EE-T|--|?M-MTXooo--M--ETT-----EX?o-X?X|oBTB-E--o?T?-E-BoXX-To-E-XMMo---XoTX?oo?M-E?|oT-f
---o-XoT-T-X--XTT?---MET-T------To?XBBTo-oBB|B-T?-o?E-?BXoT?T-o----oB?TT--?-TT--ToTTETM-T-TT-ETTB-oT??--o-oT?--oT--T-T--?XT---oTBBEo?E---X-X-M?B|-TT-TTET-XB-XMTBTToMT-TT-T?TMoBMX-X-MBM-BoX-X--TBo|?--f
-TTB-o-?TT-T?-oTTT-o?M-T-EX-ooTX----?EToT|?oX-XXoEBMXoTXBBBToT?TXT-XEB-TT-EBoTTBXXoXBo-TB--Mo?|BTT-E--Too-E-|BXE?T?T-Mo--o-o|-XT|X--XX?-EE-|oo|o-XEXTBX-E--X-T?oT|B-T-X--|TToo?-B-XTM-BXTo-TTE|T-ToTTo-f
-??X?TEXBBX-XXEE-?BEMXoX?|oo??BXoBMT-TEMB-B?--BBE?o-EB-BoBXoBBE-M|-X?ooXMo-XX-T--BXX-----TBBBE-M-??----M-XE-o-M-?Bo-?M-?--o-X?-----?EEB?----oB-B--B-?M-X--XM-o?-EBBM?-oXX-X?--BT-B-oBo--E-XooXX?X-XoXMMf
---E-o--o--|--T-X-??BE--BX-B|-oX?oEX?B?-?-T-oBBoXT-B?---M?XT--?B-o??-?X-X---M?-EX-|B---XXE-BBoXMBo-B-oM?o-B-o?o--??oX?M?-M?X-B--XMB?|---MMBE?XXTM--??-MBM--oM-XM-|X?--?M-ETB-Bo--X--BXBXXMBE?oM-X-B-XoBf
m---XB-TEEBBEBX-XX-M--E-XX-B--X-B-oooBMBE--?|??---o--BMo-|---E-?Mo--Bo---||BX?-X?M?X--?E?MXE-E|-X?---BoMX-EX|XMXBM---XMXoXXB--?-?-?M--BXB-X-XE-Mo--?oo-EE-?XoXT-X-X-?oXX-BE?----B--oEEXB|Xo----?-|oXoX-X
XXXXXX--XXX-XX--XXXX-XXXX--XX--XXX--XX-XXXX-XXXX-XXXX-XXX--XXXXXXX-XXX-X--XXX-XXXXXXXX-XXX-XXXXXXXXXXXXX-XXXXXXXXX--XX-XXX-XXXXXXXXX--XXXXX-X-XXXXXX-X-XX-XXX-XX-XXX-X----X-XXXX--XXXXXX--XXX-X-XXX-XXXX
