-------XX---o-------X-------------------------------------o---X-X---X----X------o------?X--X--?-----E--o-oB-----------?---------X---B----BE-------------------B---------------E--------BB------X--?-----
--?-----B----E-----------?-----?------------E--B---X--------oo-X-----?--B------E-------o--?------?---------X-------------?-?-?o?------------------E-------------------o?--------o---------------X-------
-------o--X-----o-------o------X--B-B-------E-----o-------X------------E-X---------------------------oB-E------------M---------------X---------X--------B-E-o--X----X--E----------------?oE-------------
-------B------------o---o-----------oX?----------XX-X------?-------?--------------B--o-----o-------B----E-------------------------?---X-------------o----------------?----------------o---B----?--------
-?------------X?------------o--X----E------B?-------------------X---------M-X---o-----E--------------?-EEX--M-------?E-o----------?------X----o-E---?--M-M----E------o---?----------------------X--B----
----M-------E-------E-E----------X-B-B-----------------E-------E--------?-----X-------?-BX--------XB----E----?--?-M---BE---------o--------E--E-B-------------------M---oM-?-E---------?---o---------X---
---X----B--o---------------------oE------oM-----------E--------X----------o------------------------?oo---------B----?--oX-----o---X--X-------------------------------------------M--XX--XB--------------
-B---------X-----------------XE--o---------EB----------M-o-------------------------------?-X----M--E--------------X-------------------------?--B---?----B--------------E-----B----------------M--------v
-o----------------X-----X-oX-----o---E--------B-B--E--M--X-------------M------------------X-----------E------o------XE-----------------X------------E-B---EM---E-----o--?--E------M------------------o-f
-------M--------o-B-------X----------M----------------------o-X----M?--M-------------E-X-------o-X-o-------B---B--X---o----------------M----------------EM-------------------------?-EXX--------Eo--M--f
----o--o-------B--o----E-o---X--o-------?-----------------------------X---X--------------------?----------------------?--B-Xo---o--X---MXM-----o-XM--XX----------o-----o-----o--o--Bo---?-----X--------f
--------o--?---B-B-----------o-o-----------o-----------oBX-------------B-E----o-------------------------B-------?----------------------X------------?----?------B---B--X-------o----?-o--------X---X---f
--T-E-----|B-o---------B?------T--M---o-X-T-X----|-o---oTT-T-?|--B-XX-------EE--o--o--M-EoE-T-----To--X?oo-B|?---T---?o-?-MM?-T------E--XX-XX----M-T--|----------BTE--o|TM-T?|--|----TT-Eo----|--T-X---f
-----o---T-o----T-TB?-TT--XT|--oo-----?---T--T-T--E-T-?--|M-?-----X-------X--X-B-E--|T-------E-?-----BX---?-o--X-B-oo-?---o-----o-?M?-o-TXB-X-M---?-|B---BT-oT-ET-MTTT-T-B--oM?--o---E--?----|--|X-----f
m-----X--T-BT--B-TTEXT-?X--T?-Bo---TB-EXX---B--o--oXT------BE----M-T-o-M--B-oT------oT--?---o---MBoT-M?---oT---?--B-T-EBX--T--XX--TX---T--------T?-Bo----E-X---o----B--BB-B?-M----X----E-B----o----M-?-X
XX--XXXXX-XX-XXXXXXXXXXXXXXXXX-XXXXXXXXXXXXXXXXX-X--XXX-X-XXXXXXXX-XXXXX---XX-X-X-XX--XXXXXX-XXX-X-XXX--XXXX-XXX-XXXX--XXXXX-X-X-X-XXX-XXX-XX---XXXXXXX-X-XXX-X-XX--XXXX-XX-XXXXXXXXXXXXXX--XXXXXX-X-X-X
