-M------------------------B-----------MB----------------X----B-----?------o-M-------------------------o-----B-------X--MX?--o-----------------B---X-?---------o-B?---------------------------E----?-----
---------M-?-------o--------X---?---o-----?-E-----X-----------------------------------XB------------------o?---------E------o------------------------X--------o------------o---XEM?--------------?------
---o-----------------E------------------------------o--------------------------X-----B--------?---------------o-?---------------?---------------?X-----------------------?----------------------BMo--o--
-o--------B-o-?--X------------?--o----------MB---B--B---------E---X----------B------X-Xo-X--X-B------ooM---X---B------------------------E--?-------B-----E---------------XX--------B----oX---X------oE--
----?-------Bo-----E-------------X------X---------Mo----------o--------------o----X----------E?-----B-------------------------------------E-?----X--X---------------X---?---------?---------------------
------o----XM-----------X?------E----X--------------X--------o-?----?-------X---?------B--X-M--X-X-B--X---------E-----E------o--X---------X-M------------------------B---o-E-?----E-X---?-----o---M--o--
--oX---B----B----------M--B--------------------X-------o-------------X--------B---M-----XB-----o--o-X------------------------o----X-o--E------------M-X----E-----------B-o-----------E-----oM---B-------
---------o-oo-B-X----?-------M--o---o-o---------E-Eo----B---?-------o-o-------B----------o--------o?-?------------------E----MM-----------X?--B--------------------o--E------B-------------o-E---------v
-----X-E--E---------o---X------B----X---B--M---X-----?---?----M------------X--------?oB-----------X-------X-----X--M--o------?-----?-X-------------------------------------?------?--?----M---------?--f
-------------------------------M---o-----B-M-----M--------o------B---X------E-o---------------M------------B---------------o?--o-----------E--MB----------E-o?----------------------------------o---X--f
-M----?------------------E--o---oMB---E---o------------------X------B----?--------------X-X-----X--X-----o------?-o-o-------------------M--E-B----------?---B--ooo--------------X-----------M-----?-E-of
-------------?E?M---B---------------------X----B----------------------------X-----B---------E-------------B------------o--------------------o--------X-----o------------oo-?-------------EoX-----o-o---f
--------M-T|--o----T-o-----XT-o----XXB--oE?--T--oT--oE----X-----T-ToB?B-MM-?---o----TT-B-----o--?---T-oTX--E--T|-o--T---E?--T--E-E-E------|o-T-oT?--|-X---T-B------------o|EM--X-TTT--?BM-o------T--Toof
--------TB-----M--?--?X--o-oX--X---To--||---T-X--X|-|----?-TTB--?---?X----o--TB-|TB-X-?---o---------T??o--B-?-X-------?M-?-T-M--T-T-XMM?--Eo--X------X----M----?--XT?-MX-oBE--X-BoB--TT-|-TT|o---T-----f
m-----T---X-MBB--------------------T-----??---------M-Mo?B----TT----T----X-B?---T---T---T---BB------Eo--BT--|-TM-T-X-----B--T----XT--X--BB----B------------T-ooE--o-oB?-B--?E----TTTEoTX------------?-TX
X-XXXXXXXXXXXXXX--XXXXXXXXX-X-XXXXXXXXXXXXXXXX-X-XXX--XXXXXXXX-X-XXXXXXXXXXXXXXXXXXXXXXXXXXX-XXXXX-XXXXXXX-XXX-XXXXXX--XXXX-X-XXXXXXXXX-XXXX-XXXXX-X-XXXX-XXXXXX-XXX-X-X-XXXXXXX-XXXXXXXX--XXXX-X-XXXX-X
