----------X-B------?----X--------E--------?o-------o------Xo--oo-Boo-E------X------------BE--o--------?--B---B----------X------?o----E-----o?----o-----------X-M-----------o---?-----?------BX----M-----
---------------------------------------------------X--------B------------M-----B---X-------M-----o---M--M----E---X?-----?--o--B-----------------E-E------X----o?----X----------------E---BE-----------o-
------o-----------E---------------------EE-------------------B---------------EB-E?E---?------------------------------------Xo-------B-oB-E-B---------------B-X--------B--------X-----?-E---?--------o?--
---E--o--o---------X-------X-------XM?---E-M?o---X------X---B-------o---------------E--------X-------------X-o---------------------E--------oo--M-------------------EXX-------oX---------o--------------
--X--------E?--------M------BX--o------MBMEX-------------------------------------oo-M---------?M-?---X--------------------X-----o-B-----E--E------?-E-X------M--o--E-------E--------?------?---oo-------
----------M------------o-----X-----------------------X-X----X-----------------?-------------B-----X--B---E----------------EEo----X---o--?X--E--------X-----o-----------------M--X------E-----X-E--E-----
--------o---X-----------X--E------X-----------------X-------------------------------X-o--------M-BM-------E-----M--B-----B--o--------X----X-------------------------o--------B----?-----o------?-----EX-
--EXB-X--------B-----E-o----o----X-----------------------o-----------X-?-------------------B-----------------X--E---M?---B-----------X?--------E----o-----------o-X?--------X-----BM--?-?X---------XE--v
-X------o-----------B-o--X-------------------------B-----------------------o--------o-E--M---X-------M-------o-E--X-X--------X-------?--------X----o--------?-----o-----------------B--------o-------X-f
-o---------------------------X--o-X------X---?B----M----X-M-?----o-B------X---------?B-----E-B---------B-o------o-B--o----------------X--o-X----B--B------o--X----X--------------------------?---------f
----X--?------o------X-----o---------o-----o?----------?----M-B-------------B---X---------??---X------o-------?-?-----?------?X----o--B-------o-----------------------------B---------B--------X-------f
----X---o------------------------------------------X---o---MB-?----------o?--E--B-----------------------------X---o---------------M-------o----------X--------o-M-XMo-----o--B------X---?--------------f
-------?-TT--?-T--o-o-T---?----o-------------------XTXTo---EB--ooT-----T-Bo----XM--o--Bo------T-B--ET---B----?TX---TT-ToM-TB----M-E-?-o----oT--o-----B-TT-M?o--B-oE--X??--------oB--T----E--M--T----T--f
--------E-|-|-E|oT-X-E---B-X-----o-X--EX---oT-------|X-E---??-----T----|--BM|-M-oX--M---------|E----|Eoo--?oME-----||-----|----o--Eo-B--|E--|M|----X-E-||----?--E----------T---X--X-|-|--------|-E--|--f
m---------|-|EE|E|o-------------|-T-M--M--T-|-----o-|T----T-X-T-|-|----|-T--|--ETM-----X-T--?-|E---||--?-T-X---o----|XETE-|-T---T-XT-o-X----|-|----E---||---XT----BEo------T?-T-|B-X|T|T?--E--?---EB---X
X-XXXX-XXXXXXX-X-XXXXXXXX--X-XX-XXXX--XX-XXXXX-XXXX-XXXXX--XX--XX-XXXXXXXXXX-X-XXXXX-XXX-XXXXXX--XXXX-XX-XXX-XXXXXXXXXX----XXX-X-XXXX-X-XXXXX-XX--XX--XXXX-XXXX-XXXXXXXXX-XXXXX-XX--XXXXXXXXXX--XXXXX--X
