----T--X------X------XT-------oB---?--??T----B--oo------X-o-------T------------------T|X--TooM--T-------MX-TE-----B-------E---X------T-T---X---------X-E---EM-------T---BT--T-B----X-o-----------X---MM-
----E?--X----------E---TT-T-------B-------T-------------TTT----------------E--TX-T----------X------------------?-M--X-T----------------T-T------------o--------o-TX-----TMo-----T----------?------------
-?------------T----E---------To----------X----o-----?---o-------o----oT-------B-T-----B----------T-EoT----T---o-TM---------T---------X------------------------B-?------------X----------------oT?----BM-
----------------T--E------------B-------M|--B-------T------?---|--------B--------------|----BTTT----T---o---T-o-T-?-T-MT----X-TX------TB------oT-----E-E-o--o------X-------M----B-X-oB-B-------o--------
---o-----------o--------------o--------T-------T-----------o-----E-|--X----X--?----?-T--T------?-----------------T---M---o---T----?----XX---o--E---M--o---B-----?M------X---------B---XT--M-TT----------
----T---------X--------T---?-----?------?-E---B--?------------TB----------T--E-M?X----B-----------?X------------o---E?--?--T---BX------------o-T--Xo--------B------------B--E|T----M----T-?--o-----EX---
---T-----------------oT-----T-T--X------------X----ToET-X---M---||----------T--XT---------B-B---B-M--?----------X--oX----MT-----T-B----E----o---?B-------------------------o---T|---------T-------------
-T----B----------X-T-T------B----E-----oME-----?T--B-X-M---------B-T------------------X-----|----EB--E-Bo------------T--------o-------B--?-X------M-------M-B------TM-----T-?T------XM-----------------v
-M-----o----oT-----T--|-----B-------T----------?----X--------T-|---X-----M-------T-----------M---------o----?------------------T--?-B-B-E---?---T--o-------------T-oET--T-M-B-M---o------T------------Tf
-M----Xo----------EX--------------------X|--------T-----TT---B----M---X--------TX-------T-----------T------o-M----------?-----T?--?T-------------?--X------------B-------------Mo--TX----ET---M-----X--f
---E-B-------X-o----------------X------------------------M---M--------B---------B------------------?-T-M------------TE--X----X-?------------?-----X-------------------E----oo--E--------To-X----------Tf
-M-?B--B-----TTTX----B---TT-------X?----------------To-----?-X----------o---T----T--B----X--------------X---------B----------------------|-------X--TB----T--?---E-T----MB-----------?------XE---------f
---BTM-|-T--o------M-M-TBoT--oo------------oE-----B--B-T---T-T--|X---o--TE-XB------T|-----|-o-TX--XB--B|Eo-o--M-T---X------TB?E--T------T-X-o-X?oT---X-?-----BBT--XX----------TX------TB--E----TE-?---Bf
------E--o-T-?T-------Xo?oX---B-?---??T-?----T-X-TX--T-M-T-oEM--TooB-----EBT---o-|T--?-T---EE??--B-----XT---TE?X-?B--XMMXT---oE---o-XT-X---T-E-TT?TX---oo---?--?Bo-T------B-------?--T-T-?----B-----?oTf
m-oM---TT----|----M-TM-T-------o------B--T-oT------TT-M---XTM-X--B-XTM-XXT-T--E-----oT---X--MX-To-B-oT--|---XM-T-X-o-T-------T------X---?X-----?M--T-?TXX---B--E|-X--T-----------MXBT-o|B-To--T-XB--T-?X
X-X-XXXXXXX-XX---XXXXXXXX-XXXXXXXX-XXXXXXXX-XX----XX-X-X-XXXX-XXXXXXXXXX-XXXXXXXXX-X--XXXXX--XXXXXXXX-XXXXX--X-XX-XXX-XXX--XXX-XXXX-X--XXXXXXXXXXXXXXXXXXXXX-XXXXXXX--XXX-XXXXXXXXXXXXX-XXXXXX--XXXXXXXX
