----------------------o-------E-------------M------o-----E--X-o--------------B-----oM---------?-B--------o-o-----------BB--------------?---o-E------?----X---X-------------------------X------?---o-X---
--X---X-----ME-------X-?----------E------------o---X-----M-----?-----o-?-M----B---------------------M---o---------------X?--M-----------------X-------B-------------------X--------X------o--B-X--------
----B-----------------X------o--X----o-------?--oB-------X------X--Bo---------------E-------------------------B-----o---------------o-??B------------------o----oo-------------B-o---------B-?-o-----B--
-----------------X-?M-----------M---X---------B-X----?---------------------------------------------o-----------M-o----------------?-----M----------M------BXM?B-----M-XX----M----?-----oB----E----------
------?-------------------?----------------XX---M---------M?---------B-------?--M------?-----X--X-----X----o-----M-------------o---------------------M---B--B--------E--------------------------M-------
--------E-X-Xo---o-----------?---------X---E-----------------------oM--------------?----M-----------------o--------------M-Xo---X------------B-X-M-----------X---?-o------------X-------X-X-----E-------
-X-E-------M-------E---------M--o---------B------B-B----------------o------o---o--B--------------o------B---------------o-X----------------??-o---------------B-----X---E----?--------------------------
---oB-X---------XX---------o-------M-----------------------B------------------------------------o----------?---------------B------------o-X-o----X------------M---------------------------B-----------ov
-M--------------------?-X-----------o-------o------B------B-E----------M-Xo-----X-----o--------------oM---------?----?----o-----M-------M-----o----X---M---X----------|------------?-------B--o----M---f
----------X---XB----E----------X----------?BE---M--------------o-o------B---------o--X------------?------o---?---X-------------M--BM--?--------------X-----------E----|---o-----?---------B----?---M---f
---------o-X-----X-----EXX-X--------------B------------X-B--------------?---M-------------B----?-----X--------E---------BX---------X------------E---------------------|-o----------------------EB----o-f
------o-------------o--o--M-B---------o---?-o---?---X-----------B---------------------o-X---X----o---B-E------X--?o--------E---?---------o----------B--o---o------X---|-----B--M-------o----------o--o-f
--------T--BX---oMX--oM--------T--ETM?M---B-X-X---?B-------ET-o-TT---o--E-|--X-B-o---EoX------X-|?-----------?T-T?|-B-T--------T-|-o?--------o-----?---B--X----oTT--o-|B--X-XX-?--EM-?---o-TT-TTT--T-M-f
--------|E---|-T??M--|----?--X-|---|-----T--?---?o--|B-----B|-B?||----X|--|X----|-|--E|---------T------------||--|o---|----EX--EB|-----|---B----E---B--TT--E-??M|--------?-|---------X--|--||-|||-E|---f
m-----T-|T-----|E--T-|--|TB--B||X--|---------|-o-|---T-X---T-E--||-||-o|---E-X--|-|T--|------|--|-T---|?--|-|||--|----TT?-EE|---T|--X----TE--T--?---|--|--T-|T-?|---E----o-|-||-X------|||-||M||---|---X
XXXXX--XX-XXXXXXX-XX-XXX-XXXXXX-XXXXXXXXXXXXXX--XXXXX-X-XXXXXXXXX-XX-X-X-XXXXXXXXXXXX-XXXXXX-XXX-XXXXXXXXXXXXXX-XXXX-X-XXXXX-XX-X--XXXXX-X-XXXXX-XXXXXXXXXXXX-XXX--X-X-XXXXXXX-XXXXX-XXXXXXX-XX-XXXXXX-X
