-oM------?--------------------------E-B--------------?B---o-------B----?---E-----E------M-?-o--o-?----------?-----X------o-B-X-------X--X----------B------XB-----B-------------X-------------E---o------
------------X---B-----E?-----B--E-o-o----------o---------B-----M--------------?---B---X--X------?o--------B--------------------?-o---------B----o--------------?--?-------o------------o----?--o--------
--------------X?-------------E----------X------E---M?---E-------o------------X----------------o--X------------o-B-----------------E---B-E----B---------B-----------o-----------------------?--o------?X-
----BE-----------X?--M---X---------o-----M-----B-E-----X-------------o-----------X----X-------Eo----------o----oo--o-----E-----------------B--X-M--?----?-B-X------------B-----X-----E-?----------------
------oXB----M----E--?---B---E?----B?-B---------B------------X-o--o-----X--X------?o-----oM-X-------X------Mo-----M------------oX-----------?---------------?---o-MB----M-------------o--B---?-------X--
-------------E--B--B---E---X-M--o--------------B----X-X---o--B------X----E----------B-o-------X---B---M---?---------ooM---XoX---o-X?--o------X?--------------B--M--------oMX----X--------?--------------
------B--?---------?--------M---X-?-------------E----?-----------o--o------?-----BM-----------?-----o--X----------B----XX---------XB---------Bo-----------?----X-?--------ooo------?-------B--------Xo--
-----------oB-X---------X---------------------M----o-o--Bo-----X--X-----o-----------?----------------------------------------M--X---X---------------------------o-X--M----------o---X-----------M---??-v
----------X?------X-o---?-----------X--------------E---XM--o---------------B-?-E----------B------------------------E-------------------------------------------X----------B-----------X-----M----------f
---X-------EB---X------X------------o-------M------?---------Bo--oM-------------------------ME-?------M---X--------M--------B-----o--o--X-----M-----B-M--E-------------M-E-M--?---------?------M---M---f
----?----X--o----------M--X-------B-B-------o-XB------------?--o--o--?B----B-------------?X--B------X------------------X----X------------o-------------------?-----B--------------o--------M------?-E--f
---B------------M-------M----------Mo--?----------?X-X----E----------------------?-o---X-?-o-XXX---X----------------------------------B--o?--?------------------------?---oo----B-------------------?--f
------T-|-TX--X-B--T-?-E--?X-o-----------T----o-------ME--------T-----MT-XEEMT?--T---XXBM----?E|-oEXM-T----?-------T-X-T---------T-o?--T-----o-----o-E-X---B|E--o------T---TT--B----TX--?X-T--o-TTT---Bf
------X----TET--o-T|T|T-T--------|M----T---M-o-T-M-----?o--o---BB----MX?--E--E?--T-X----?T-BEo-X-E---ooooTT--E--T-o---|TM---MT-M-----B---TT-o---o--|??-T----T--?-|T-o-BX---oETo-X-BBE-M---oT---------TTf
m-----o--X|To-----?-?To--BM---------o-T-------EMB--BX------TBE--o-----To--T-X-?---oB-E--ooT--X-X-----TX-T-----??-B---B-X-B-?---M?--X------T--TBT---Bo-?--E------BX--TM--XT--oB----TB-oT?X-|E--T--o-T--BX
XXXX-XXX-XXXXX-XXXXXXX-XX-XXXXXXXXXXX-XXXX-XXX-XX-XXXXXXX-XX-XX-XXXXXXX-XXXX-XX-XXX-XXXXXXX-X-XX-X-XXXXXXXXXXX-X-XXXX-XXXXXXXXXXXXXXXXXXXXXXXXX-XXXXXXXXXXXXXXX-XXX--XXX-XXXXXXX-XXXX-XXXXXXXXX-X--XXX-X
