-M-|XXo?TEM--??M?|To-TT-X-oMo?EE--XT-ToXooM?TT-oX--M-TE-TTo-?TMTMM--B--B?X-?XX|BE-T-T|?|-ETEEB----MEEoMX-E-E-TEM--E?TooB-T?-To-TTXoTTT--TTEoTTTMX--o?-T-||T?|Eo-B-?-Bo?-TXT-T---o-oTXo--XMMo-|oX-TBoXT--
-o-o|-?TEo----X-BBT---?T-T--M?----T-XTB-ToXE--ET--MTXXTTT-XMT-o|MX?TT--oXTTXT?X-E-B-XB------T-ME-oEo-ooMBTT-ooTTB-MMooE?-XB|--X-B-XTT-TTB-o|E--TXoTT?-X|?BXXTT?-oBo?--?X?E?T?o-BT-EX-BT-TM|?ooMoBEETX|--
-X-E-XXTXT--Boo|BXB--MTo-ooBTTT----MoMX-BXXEBM-EEoM-oMEX-oX-TT-TX-Boo-X??o-E--X|oXB--?o-ToE---ET-T---B?TXEoXMToo-TB-?BX?XoT--T?BE|-X-E-XT--oEE-MM??--oo---oMX--?X-T-BMBTX----M--?TTEB-XXBX-TBo?X-?-ToT--
--T-ET-T--oT--?XBE-XX-Mo--oX---B-T-XTT|---X-||--XE?B-M---XT-EX-|TTEo-BXTTo-TB--o?TT-oTX-oo-Bo-TTX--XE-?oMo|XXT?T-E--oXX?---|T-oT-MEMoTB-X?TET--o--XoTEBXoToTBMXoXT--ToE-B-BB-o-EBo--M-o-T-XB|M--BT?X-o--
-M-|E-E-E?--o?-oT-XMoTM-M|BT-B--|BT-TTBBBoE--X-EoEooTT-EooB-M--?XT-X|-XX?--?-?B?TT-E-E-B-o??-?XTTXEMETX?----oTT-XB-o?|-M--X-?T-E?T-ooT|oT-oX-XEMTTB-XMB?-??TMB-T?oX|B-o-|ETX?ET?T---BB-M|----oTTTTMTo?E-
-TT-oX-|B---T--T|TTM--M--?BoT---M--|?-TB-o|T-?XT-T|?--?BEBB-?XBE-T?-XE-oTBEoo?--|MoTTTE--T-T---B?E-XoB-T-o--T-TMoooXT--E---?---B|XoMT-----?TXTXoBM-o?EXT|--TT-BToTMETM-?-EMo?-TEMTXo?T--oT?oX-?MT-TB-?M-
-o-o-o-oTM?-EX-|-XT--Xo-T---X-TBBB?X|TTE-BoM-B--BMoo-X-oB---oBX--EMToB-?-|-X---BT-E----||?-XXETXBTX--B--B-TTXBXBE?oE-X-o?-Xo-BoT-TX-ooEX?XTE-TT-----?|--MXooTX-?T---|-XT?|-M-X--TTT--TTBBoT?TT--?M?-To?-
---MB-MT-To--?--T-T?----?M-o-o?o--E-?-?T?-XX-XT-TBXE-BoBM|TX?T--XTT--T?--??E-o---X-TT-BoMMo-?X-M-oMX?-oB-ETTo--?-BX---XE-EBT|oEoo|-TMXT|TX-oB-oXB-TBBT?----MX--MooXo|-?E|BoT-?T--T-XoB-oX?--MT-?BTXTBEBv
-BXBMoo--Xo-XXo--?E-XBETBT-BE-XEETXBEM-o|o-?-TTXXTTE-T-T-TXTToB??Xo--E-EEo-?MT?T-oo?TTo---oT-T-oTXT---oM|MT--?-E-T---XXTXE-EB--?B--o?oT--?--BoEo|TT?-o---MoT?X--T-E-oXTo-|T?o|E--X----oT-TMBo?ToTT-T-E|f
----M-To-?oXX|TBTo-XT-EoB--?Mo--?-oME|o--TTTT-oBE--T-B-|T-TToB?ooX-oT?TB-E-|o|-XX-BXTX-|?X-MTo-XE-X-|-T----T-T--o?EM?--B?TTTMo--B---ooBX?T-BTTT??--o?--B-B-BXE|-o---TTBX-XTTT----T-M-o---XM--X-?T-To---f
-TT--X?X-EB?--M||TT-T-X??--M-TEMT?-TToTo-M-TTX--T-E-TT?BTM-X-TE-ooE?oT--T-MT?-?TX--T-Xo-oET--ooB--T---o-T?TTT--?-BBMXT---o-TX-o-M-T-oo-B-BE--oTB-M-o-|ET|o||T-BM--X----TB--|E-B-?TTX-M--|o?-T--TT?oB?TTf
-B--MX-----o--oo-MX?T--E--oB--X-X-E--T--oTX-M-TBEoXE--E?B--o|oB-BET-?--?-BTXT?--X-oXo--XTMXB-TB-TET-oXToXT-TXToTTTo?T-XoX--|T-ETT-X--XE?-T-MX--TTMTX?T---X?T?o|X--?MMo-METTTTET-oMoM?X-M|?B?-XoMoTo-TT-f
-Bo?-|B--?MBB-?-o-|B-X?E-MX?-MB?BBM-MB-Eo-X-o-B-X?BMXTXX-MM-XXMM-X?-XXE-?--?-TX-XM---|?B-X-XMB--oo-oBMB-X--?o?BME?BoB-B-?E-B?XoE??-X-o?Xo-B--MXB--X----B-B-B-EX?TMXo-XE?E-oMX?|-X--oXX-BX-|Mo-XX-?o?BE-f
-|-B--???-Bo?|-?-?B-E?oXXMMoMXEB--XoMXM?-o-X---M-E-BMXB?Bo--oXB-----|B??Xo?BX-?XoE--?-?-?T-EM-BMo-X-o-XBE?-oXB--E-M-XX--M----ooXXB-??XB-B-BEBX?B-??XoXoXE--B-X-B-o--B-oB--oBM--o?-TM-BB-??E--?-o---?-B-f
mMBMo--BX-Mo-?|?----X-B---B-?---BEX-X-BBX-M-o---XBB--E--E-o-XM---o-o-M??BEo|?E?-MXB-M-BXXB-BEB?-?B-BB--BoT?-oX?--ooXXoBX?X-EXBo?BB-XXXo--X-X-B?BoXMB|-B--M-?BoXE?X-MB?--MBX??--XMoBX-X-Bo?BoB-BX--BBBB?X
X--XXXXXX--XXXXXXXXXXXX-XXXX-XXXXXX-XXX-XXX-XXXXXX-XXXXXXX-XXXXXX-X-XXXXXXXXXXXXX--XXXXX--X-XXXXXXX----XXX-XX-XX--XX-XXXXXXXXXXXXXXXXXXXXX-XXX--XX-XXX-XXX-X-XXXX-XXX-XXXX---XXXXXXX-XXXXXXX-XXXXXXXXXXX
