-------E--E--?------M-------E-M-------o-B-----------B-?------Xo----B?X------oB--------------------------------------o-M------------E-?-----------M-M-----o----------------------------------o-------?---
-M---------X--oo----------E-o-------o------E---X----------X-----MB--B-------------------------XX--oo-o-------oMoX--E----------------o-Eo--M--o---B----E-X-?--X-------o----M-------X---M------------o----
-------o-------------------X-----------M--------?--------------------o-o-----X--o-B--B-------------X-----------------------?----------BX--------oB--------?E--B-o---Xo-X--E---o----?M------M------------
----------------------------------o----?-Bo-----X--M-?---?--------o---------E----------------E--------o------X-o---------oX-E---X--o--E-----?-----X--X--------X------MXEM--?-----------?----?--------B--
---XM-X--------B--B---?-----------X-------M---B---X----X?---------------------?-------------?----Eo-o------------------o-------X------o----------X--?---------o---B-------X-----X---------------------o-
-------o-?--B---------?X----------X------M--E---------E----------B------M--E--??o---E------------------------E---B---?-----B--o------?-----BX------------o-X------------------o-------B-------------o---
-------------B---?------XE--?-----?---?------o---------X----------E---------------------------M--Xo-o------B---?o----E-oX----MM-----------?-------------B------------------X-E-E---X--------------------
-------------o--M--------------E----E-----------M----X---M----o---E-----?X---------?--------o----o-o-----X-----XB-------------o---o--BX------E---------X-------E-----------M-EXo--------X--------------v
--X----E?--M-o--------------XB-X---------o-------------E-------------------------------B-------?------------------o-----X--o--E-M---o----------------XM----------------------------X--------?-------XX-f
----------B--XM?-o----------o-------o----o--------E---?----------o---X-----M-----------X--o--------?---o----X--E-M---o------?--X--------M------------------Xo-----------------------?-?-------------o-?f
-----------------X-E-----------------------o-----------o------o------------------B------B--------------X------X-X------M-----o-------------------------X-----?--?------------E-B--------------XM--Bo---f
---B--oE--X------E---------?----------o---------?---------?--M----------B-----X-X--B------------o-X--o-------------------?------------E--------------------------o-E-o---Xo?--o----------------MoE-----f
------o-T-------E-TT-TT--?-T-X---T-MTTT----E-B?-XTT-|-------T--?--?|--|---BTT-T-----------BoXE---ETT?---X??E-------T--o---X|-X-B-----M?o-|ET-B-ET--T-T-M-E---o--B?-T--TB--T-X-o---?X----T-|E|M--T------f
------o-EX-----|---E--|-|----X?-|-||---|--T---T-?-oT|o---TBB-o----X--|-TT-B--|X-o-----B|TX-|oE-|---||-T----||X-||--Eo|BE---?|--|-T--|--TET-E-|-|E--o----|-|---|-X|-M||-TB---|--|---|-o-|-|-T----T|E-M-Tf
m------|T?B---E---T--oT|o-|--||---o|--|-|B|TE--|-----T-|X--TTT-B-||--|---||M||-||T--|---oT|--|B---|||-o?--M--B---|-E-o-|X-----|---X|||T|-||-|-|-?--M||||E|o-ME-T-|o------|--X|--||o|-----T-oB|---||o-E|X
XXXXXXXXXX-XXXXXXXXXXX--XX-XXXXX--X-XXXXXXXXXXXXX-XXXX-XXXXX--XXXXXXXX--X--X-X-X--XXXXXXXX--X-XX-XX-X--XXXXX-XX-XXXXXXXXXXX-XX-XXXXX-XXXXXX-XXXX----XXXX---XXX-XX-X-XXX-X-XX--XXX---XXX---X-XXX--XXXXX-X
