-----------B------o-oX------------X------o-X----BE--------B--------X------------X---------------o-----o-o---------o--B---M----?------------------------M-o--E---?-XB------------oB-X-B--X---X-------M---
-------------------------B---oX---------------------o----------?-o-E----X-?---X-X-----------?----B--M----------X----E-BB-----oX----o----------?--X---X-------------------M-------oo------------B---X--o-
------X-?-----------------------------------?---------------??------oEM----?--------X-o-B-B--o----------Bo-Xo-----B-BB---?---BE-X----?------------B--?X----Boo----o-----------X------------X---o--------
------B----o--X----------B?---o---------------------M-X------?---E---X----------------------------------Mo--B------------------------M-------------?X?--M-B----?-X--?----X-?-------oBX?------X----------
-----?-X-----------B------BX----o--------------o-X-----------o----o---E-----B--------E-o----o--X------B-----o--o----X------------------E-----M--Eo-B------E------?-----?----------B------------B---X-o--
------------------o-----E-E?--EX---X-----?-----X?---------o-o-------o--M--X----------------E-X----------------------X------M---XM----------X----------o------o-------------------X-X-?------------------
----M---------------X--------------X-------o---?-----X-------------?o--------BX---X-X--o--X------------------------M-X----------BE-E---------X--------E-----------------------XM-----X--------------??--
-----------------B----------------?----B---XM----XM--o------------o---?----M--------o---B--B-o--X-----------------o-----B-----oX-B------o--------------------------------o----E---------------------E--v
-----B------------------E----X-----X-------MX------------BE-----------------o----------------B--E---X--------------B---------EB-----o--------?--X-X-------o?-----------E------------------X-------o---?f
---------B----M-?MX---X--Xo-------o-o-o---------Mo----------------o---X---------X--------------X-------?----------------------X-------B-----------M---------X---E---X-----------o------------X-X-E-----f
----?------------EBX-XE-----o------B---oM---B--X--------X-------o------------------------------------X--Mo----X-------o-o-----?------oX--------------o-----?-----X------M------B-B--E----?X-o----------f
----E----------------------o-----------------oXX-----------X--B-------------------------M---------X--------?---------M-B?----------------M-?------------E----o--?----------------------o-----oMXX------f
--------T??-TBT---T--------T---B---o--MBTM--M---T--E-ToB-B-o--?oT------o-MBooMT-?T-B-?---TTE----XX-B-X-?TT-ToBEE---MB----o-T-TXB----TT--------B-BT-E----T?BB-o-B-?--E----EX-----?o--------M---------E--f
------|To---|-|----E----E|-|E-T---------|TT--TX------|-E--B--E-X|-B---?--E-?----?|----|--||---|-oEE-B---||T|E----oTEo--o-B---|B-E-?-E|X--o--|--?M-----|-X-----?BoE------EB------EM-----E|-------oX--T-Ef
m------|B-----|---X----E---|-T|-o--?|-o-T||-B|--XB---|EM----|----E-E-|-o-X-------|----|-o||E|-|T-T?-----|||-----TTT----E-|--M-E--M-X-|------|---------|--E--Mo----Eo-----------oX-----|-|oTME--MB-|-|MTX
XXXX-XX-X-XXXX-XXXXXXXXXXXXXXXXXXXXXX-XXXXXXX-XXXXX-XXXXXXXX-X-XXXXXXXXXX-XX-XXXXXX-XXXXXXX-XXXXX-XXXXXX--XXXXXX--XXXXX-X-X-XXXXXX-XXX-XXXXXXXXXXXXXXXXXXXXX-XXXXXXXX-XXXXXX-XXXXX-XX-XXX---XXXXXX-XXX-X
