--B----------------o-B-o-----E------M?----M--?-E?--EMX?--oE----?--X---o--X---oXB?--------M-------?XXM-o?--------?----X--EEo-E-??MB-----X?o?-X---------X-EMBEX-------Moo?-------------XEX--?---X-E-------
--o-M----B---ME--o--X--oE---B---EM--Eo-oX---B--BEoMB-o--------XX---M---?B---X--E?BX----X---M------E-?oX---M?-M--B-----E---B----E-EB?M?--M--?o-E----?oX?X-M--B?---M----X-o-----o---E------M----o---E-----
--B----?-?-Xo----M---X--XMX-E?-----o------M-----B----------?MEE---E-X?XBB--------?M---M-----E-o-M-M?-B----??EBX-?---Mo--?----------o-----E-------------oo---M------E------X------XM---XM--------E-------
----XB-?-?B---o---?M--M-o-MBM----o--EB-B----?-X-X--------X--Bo---o---E--?X-------XM-B-B----?------BX-M-?-----XB-M---------------B--------XM-M-M?-o------o---B--oME-BB-B------B-X?-o-------BBX---?--o-B--
-----XX-?M---------Eo-E--M?---?XB?B-o-B----o-X--E------------E--o-o------X----?BM-E----X-EE----??X-M---B--E-oB---M--?---B----XB-E--Eo--X?-oX--EBX-?M-?-o--X--M?-------B-X---o-E-B-E-E-B-EX-?-B----------
--?-X---?-X-?X-X-o??---?-----BM--o----------M-Mo----X-X--o-B-BBE------?-B-E-?--BE---XB-M--XBE??---X--XM----o-o??X-E----E-Mo----o---X---X-XBo--o---o---?--?M---oo---?-?---oE-E--?-----X---E-----E-M-B----
---?-------?-o-E-?--?E-?-------o--------M----o-o-B--Bo-o--?-E--------o--X----M----?------X-XM-B-------B---M------?-X---X?---XB---M------?M--X---E-?MEB--M-M----E--E?--MM--?-o?-B-?-?-----B-?MBBBoB-B----
-XM-M------o-----o-B---o---------X-EEB---------------X----X--Eo---MM-B--?-EX?X-M-E--M---M---B---------E---------M-B-X---o---EMB---o--?M-------B------X?------oMoM-BME----------?o?--B--------E-BMB--X-Xv
-BB-EXB-B--EX-BM--Bo----o-XM--E-------------MM--ooE-?--?E-X---X--XX--Xoo----?----E----?---XM-----E-----o?-oE--MB-?B-X-B---E-o--o-M----B---o-------X--B-?-o-E--M------Bo--M------?EM--B---E-EEo-o-----E-f
-o-??--XX?--E-oM---B------Xo--M--XE--X---?E----X--oX-M---X--X---------BB----?----M--?o?-E---X------XoX----B---X------ooB-----E-----o?E-----E----B--X-------E---B-BE---?B--E------E--?-----BE-----o-M-o?f
--MEX--EX?---X-------E--E--oXo--o----o--X-M---BE---MMo-B----X-Bo--E-B--X--B--X-?--BB-------------BX-o-----E-EBB-M----B-?-o--?----M---?----o-o--M----X---MX-B---BB-X----Mo--MB-o?-M--B---------oo----?-Xf
-XB-o----oB-----E---X?X-?--E-M----oBE--o------B-----o------?-XM--X-----?o?-X-E-?XM----o-----oo--B-----XoEo--o?-----X?X--?E?E--B--?X?Mo---X-------o-------M--B---M-?-X?-?----?Mo?---o-E-MX---XEM-o-X--EXf
--B?-Bo-EM-X----?-M--MEE-XooX---?-M-oo--?---?--oM--o--X-X--M-B-----XX--MBE-?--M---EBE----X--B-?--E--------B--?-------M?----X-Xo---o-oE-------E-M---?-X----?-XM---EBM-----------B------BE---??-B?-------f
---X-E---X--MoX-----E-----X------XE--------X-o?-------E--?--B-----------?---?oM------------EM-Bo-M--E------o-o----X--X---?--B--------?--B---o-M--E?-----------B-M--B--MEE-BM------X-X--B-----B-?--X----f
m--------------------------?---------------------------------------------------------------------------------------------------------------------------------------------------------------------------X
X-------X-X----X--------------XX-X-------------------------------------------X--------------------------XX----X--X-------X-X----------------------------X-------X--X--------X-X-----X-----------X------X
