--BXTBX---T|XEMM??--?TM??-TB-E-oT-oB-TTTM-T-MT-TM|-Too|---MT-o-TET--EE-|-TT---E-EXXT-|BT-ToMX-?-o----TTMEo--TT?T?T-|-?-B-?-oMTTBTMX|T?MM-TMT?-M------T??o--|-TX--T?--B-X-|oXoo-X-BB-T-?-E--o|T--B-MoTX?-
-T?BTT-oTTTB---T-TB-|XoEBXo-E?E---T-M--MT-T--oMMX--XBE-To-XTX?-o--BTTo--ETBo-ToTT-XXTo---X|B-TToTE-o----?M|X-Eo|--BoT--XXT-oo--T--oTXooX---|oEBM-?TEo-XT--ToXoE-?T--o---BBoEBMB--X-o|-o--?TM--XXT?Xo--X-
-?-oEo?--E--X-??---?oM?|oT|--TM---E|BT--XT-TX--TB--?-TM-E-T|---M--?EM--XMEB|--E-?TT?--?BooToM-EBXo--BE------oo|T--oXB?MM-B--o-|---oXXTX|T|?-X-T?--T-oTBE-oo-Boo---oT--T?oTBXX-E?MT-?-Mo--BTToT-o-Too-B|-
---E-oo?---MXTM--T?-T----BT--TTTTBoEXo-T-?-MBo-o-BMoXX-o-EooooT-oToEXTXMBoT?-|--M|X--ETooBo--ToB-Xo-XB-B-To--XooBE?BToT---XTTBT-MTTX---oBX-TMTBXM?oEBTT-BoT?XoEo-oo-MB-X-BXooT-TBEM-Eoo-XBXTTTET|T-?o-E-
-X-T??T--BX-X-X-BXEETBX|ToXTX-oXoXM??B-TM-MM-----Xo-XETXT--T-EEXM?X-B--oB-?BE-BT-X-X?-To--oXo-|T|-E--?--?TMoTET-B--?XM-------E|ET--BE?X--XT-T||oo-|-T-TBTT-oT-X-?-BX--MX-TX?-?XT-E-BBTBB--T?X-|T--TT-TX-
-T|-X--?E-oBXo?M---TT-X?B---T-|oTX-oo-BX---BX-oX-o--TTT?--Xo-EX---?To-X--|-XMX?-o-o-oXMoT-BMTTo|-XTXX--TMT-oBTM-B-T----T-BEoBBTXMoX-Bo--T-o-?|X-?oX---ooMT?TB--TTBT--oTToT-T-T-TTT--B--XT-?T-T----o--EB-
--oT-TEMXB-?X--TT-X-?--T--T?TEo-B-T-E-BM--MTMT|-MX?XToTTXXB-X-T-B----T-XXTEEoo?oX-?BM-T-TT-XX---EBB-|T-TMTT--T-BT-?BB-EM--M-X|MM?o-TT-TE-E--T|T-M|T?--M--E-To?-T----?-oT-XX-TBT--BEo-To-BTM--|?-oTooXBT-
-XB-M-TT---Bo--BEX---o--ToTo-TMoT-ET-oo-o?MMo-o|B|--oB?-?T--?oTo-M--T-BEET-X-X-MT-BTBXEooT-TX--E-BETM-XoT-MX-B?TX-BTBET-|T-XTMXXX|-TXXE-To-T-BXoM-XXXoB-|ooTTM?M--MBoT-XoB-T-?X-o-TBB?-X-?-X-?-?B-TXoTXv
--B|M--TT--o-MT---T--TE-oTTTMT-T-M-?--TXX--?o-X|?TXX--ooET---TT-TX---M--||o-?-XXTXB--o-E--E--T?B?XTo-XE--XToE?XX?TTB-T-E-??TX-T-XB-T-T|X-TXX---MXTTTX|T--?-T-T|T-T--?T|M?X?XB--TX--oE---X---BX-BTo?XM?-f
-ET--o--M-oTM---TEo-oXB--T--oT?M?o-TT?BoE||-?----?T-TTT-MB-TooB--T?M?-TM-XMX-T--MB|E---?EB|?E-XoT?XBX---E-XXX|TB-T--M--XoXXB--Moo---?E?B?-B-BB----TooBEoT|XoE?X-oT?oTTTT?Bo-T-EBooET--?XoBET-BETTT-TB-|f
-Xo-?--T-M?-o-BE-MX--T--T-EXM---TB--T-?o--To--?-??To---oM?TE-TB-?T?ooX?o-o-TMTo-X------TT|XTX-TToEX-??-T---oET|T--M?TT---X-XT---T-X-T??--T?-XXBE-BTTM---o-TT-BBo-Bo-X-XBB|--T|TTE-M-T-?o-B-ET-oB?-XX---f
---M|-T-ME-T-XT|TBo--BXTB|?oB-Xo-EBTBBE-T-oo--E-?T?EM|-o?-X-|MoBX-|--BM---B-BX-TB-oB-TT-T?oE-oB?-B?EX--E?---|T---XBXM-TX-B-T?oE|o-BMXB?T----BT-|T?|?oo-o|X|-TT--?-TTooo-XM--TE?Xo-Xo--E?XBX?--E--BoXXo-f
-BX-----B-EoBo-?----oMMX-EMXoo-XE?BX-X-XXMX?ooXoBo-MBoB-M-Eo?BM-Bo-oTM--oX-XXB--M--X--BEB-MBTMB?MB?oXT--X-B-XB-MEE-TooM-XXBoX-o-XEXBoEB--?XX--oo-?BTBX|oX--M-X--o?MMX-BoBo-X-Xoo-M-B--BMX---XET?BBXM-X-f
-XEEBooBXX-?-B----E--X?X-X-XX-BXT---?-B?--MB-oMBM?BBX-B?-o--E-BT-MEo-B-BX-XX-BB?--B-X?-E--MXo-B--o-o?MBM?-?--B-XXoX-?-EX?ET-?EX-oMXM-BXBo-M-----oB----??|oB-|-BMTBB?-B-BoXoXoE-Mo--B--?-XX??E-T-XoBB-Bof
mM--XBMBE-X|B?-XEo-MB-ooB--XXB-T?E|--o?BB|?ooMoBB--o?XXXXoMBX-oBXBX-E--BEoME--??----XE-BX?BBo-E?-?-|--o-o?oo?EBB??-o--MEE?B-?XBXX??X-o-o|B-E||-B?o???o-MoX-M?BE-B-?BBXEXM-MEBEo?-oEEoBE??T-o-X--X-X?-BTX
XX-X--XXXXXXXXXX---X-X-XXXXXX-XXXXX--XXXXXX--XXXXXX-X-X-X-XXX-X-XXXXXXXXXX-XXXX-XXX-XX-X-X--XXXXXXXXXXXXXXXXXXXX-XXXXXXXX--X-XXXXXXX-XXXXX-XXXXX-XXXXXXXXXXXXX-XXXXXXXXXX-XXXXXXXXXXX--X---XX-X-XXXXX--X
