-B-----?--------M----------------------------X----X----X------M----Xo---X--------E-----E----o----------?-X---X----------?X--------o-----X-----M--M----------------X-----B------o-------------E--X-------
-----------------------?-------?--oBo------o---------X--------o-------oX--------------X--M-B-----------M-------------M----o-o----------------?--------E-X-X------------------o----o--------X---BB--o----
------------------------E--?-----------X-----------X-----------o----??-------o-?------------o-?--X-------X--------------------MB---------------X-------o---B?X---EX-----E---------X--------------oo-----
---------------------o-----------o------------BX-------?---------B--------E---??-----------M-------------EEX---BX-----X-------X----------o---------?-Bo--Eo-E?-------M-----E----------------X-----X--X--
-?----------o--?M----------o-B-X----X--o----M-o----X----?-X-----B-?--B--X-----------------------------------B----X---X-----------B--------?-?-o----------?-X-----X?--------X-------X--X---------------?-
-----o------------M----------o-----X--------------------------------Xo--------?------B----------M---------X--B---------E--?-EX-------?------M--o-----X--------------?--B-----X-B-----B----------X-------
----BB--?-------B--------------------o----o-X-------------?--B-------------o-B-----------?---o----------M-------E-----?o---o-----------E--X-oB-o------------------E-----------MB-o------E---X---?-------
-----------?X------X-----X---M-----------X---------B--X-Bo-----------------X?-----EB-----B----------E-----------X--M--X-----B----o-X-----B---ME--X--------------E-----B----?--?---X----o--------X------v
------------------------------E--o-MB----oM----------------------X-?---o---------------B---------o--?-------------?--o-X--?----B---o---E--o--------------------------X----M--------o---BE----o----X-X--f
-----------------X--------------M-B------X-------E------E-o-------------------X-X-o--X-------------------X-----------------------------X----X-----------B---------B------M---?o--X-X--EX---------------f
----MX-----o---XX---------------------------B------------?--?-M----------?--------------------------M-----E---B----B--------------?------------E--------o----Eo-M-----------------B----------------M-o-f
--M---X-XX------M--X----E----------?-------o-?----------E---------EBX----------------o--------------X--E---o-----------------------oE-B-------?-M-M--------------------XM--?M--o------o-------E-----M--f
------E------E------|?oX|X--TTo-X-T-M-T--T--XT-T-----M?oE-?-----T-----?oo-X-|XE----XTT-----Eo----?T-X--T--T-o--X-?-?-T---X---o------?-M--T-X-----o---T-o?E--oTT---oB-B-To---|--B----TX---T------TX--oX-f
------B-ET-o-X-M-----M-X-X-o--T-|--o---?-M---o-?|-------------XT--?oB?----EB---------------T?-T-E--EX-EB?-o-ToEBTT-T---?T?o-T-T-B-X----T--T?----XTX?XTT-M-TT-o--BXT-?-|XM-X-MB---TB-oT-X--oTT----To--o-f
m-----MX-?T-X?--BT-E?XTT--T-BEE------T---MX-X-o--M-Xo?-E|TT|-oT-----|------B----Eo-o?----B--B----T--oT--oX-?-oo--??X--X-T---T-ETE-T-X--B--|-o---T-----o--T-?-To---BB--oTBX-ME-M-|XE--T----?---o---T?B-|X
XXXXXXXXXXXXXXXX-X-XXXXXXXXXX-X-XXXXXXX-XXXXXX-XXXXXXXXXXXXXXXXXXXXXXXXXXXX-XXX-XXXXXXXXXXXXXXXXXXX--XX-XXXXXXX-X-XXX-XXXX-XXXXXXXXXXXXXX--XXX-XXX-X-XXXXXXXXXXX-XXXXXXXXXXXXXXXXX-XXXXXX-X--X-XXXXXXX-X
