-------------E-----XM--?-?-------------------E----o-------o-------------------------X---X----B------------o-----?M-------B-------B---------------XM--------------------X---B--------B----?--------------
----X-----Eo-----------B-------------o----?---B-----B-B-o---------?---MB----M-----X---------------o-------------------------------oE-------E----o-M---X-o?-E-----------------------------X-----?o-------
----X-M-------X------E------------------X----X-------X--B--o---------E------X--------o---X------o------------B-o-E-----B-----------X---X---o?E-E-------------B------X-----------------X------o------?---
----------M?--B-X-----B-?-----------------------o--------Eo-------XE---------M----------------X-o--------M-E---------o--------------------------------------------------o------------o----E----o--------
-------B-------X-------------------------X--------E-?X---------------X----------X---E----------------o--B-E------------X?-X-----B--------------o-?--?---o---X------------??---M--X----------------B-----
-X----E-------E-----?---X--o----o----------X-------------o-------M------B---B-----?o----M-----------?-X-------------------X---M-----B----B-X------E-?--X----------oE----------o-o----------XB---X----XE-
-----X--------?B--B--?------Mo---X-------X---X---o---o------E-----E----------------X------X--oo----------------?--o?BM-----XX-----oX-o-------------M-----?------X------X------------?-------------------
-X-----------X-BB----------B--------o------------X-E---Eoo---E---B-E---X-------X?-o-----------------o----------?M------B---------B--------------o---------BB------------?---B------M-------------------v
-----?--o-------------------X-----o---X?-------X-X----BB----------X?-------E------------X---X------o----o--?-------M---------------?--------o---------------------------------B------------X---------o-f
--X------X---------o----B-------B----?----------?----------XoX---------M---B--------X----------o------------------------o--------B------BX----------------E------B----o------B------------B------------f
-----o-------E--MX---E-------------?--o-------o------BX-------------o--------------o-------------X----------------B---?--------?---------------------o-----------------------------------X--E---X------f
---------------------B----------X-X----?---------------o-----------------X-------------------?------X-----BM---------------------X-----------------o------o-------------BB-----B---?----B----------M---f
-TT-M---M----TT----M--T------E--TB--------TT-T--o??----|XT--T-TX--M--T------|?-T--oT---?TT-ToT-TX----TXX-XB-M?---M-T---o--T?--M--?T-------?--T-T-B--MB--BXoo-E--T--o--X-o--X--T-TB-T?--B-E|---?-X----B-f
-----o--?XX-----To---T-|T-B-T-E---ooT------oo-M-T-T----X|T-|---E--?-M-MT--TE-TE--T|-TTB-?-oBBTM---T---?---X-X---T--oo-MT?o-?----------T---T-oT-----|-XTB-X---X---T--TT---B-To--oX---T---o---X--oB---o--f
m----X------TXTB----o--T|----T--E-TET-----E--|o----X--------E-T-ETo-MBTo--T-?T--TX-o--------X------T-B?oo----o--o---T----T-B------XE----o-?--XT---X--?--|X--o------X-----oMMM--MMX-----------?-|---?o?BX
X--XXXXX-XX-XXXXXXXXXXXXXXXXX-----XX----XX--XXXXXXX-X-XXXXX-XXXXXXXX-XXXXXX---XX-XXXXXXXXXXXXXX-XXX--XXX-XXX-XXXXXXX-XXXXXXX--X-XXXXXXXXXX---XXX-X-XX--XXX-XXX-XX-X-XXX-XXXXX-XXXX-XXXX-XXXX-XXXXX-XXX-X
