--------o-X--------------------o-----o---B-----oX--X-----------------B-------------------------B-----------------B-X-----oB-----M-------------------X-------o--B----X--------------o-------X------?-----
---B-----o--?------------------?-----------------X-------------------?-------?-----------------------X-----X---X---X---------------------X----B---------X----------------?--o-------------B-------o-----
----o----------M------?--M----------------------E-------?---------M---X-M-B-?---M-B---o-----------EX----o-----o---M-----E---X------------o-X--o----X-o?X--MB--o-----B---X-o----?--------B?-Mo---BEE-----
-o---B---?----o--------------?----M--X------------------XMX--------BB---------------B-----------------B-E--X-----------------B---?----oE--------X--??--------M-------o---o---------------??----E------o-
-o-----------EMB-------------EX---------B-B?E-B--------------B---------------X--EX---o----------X-----X------BM-----E--------o-B?----------------EM-----o---------E------X-------o--o-o-----------M-----
-------o----?---------------M---------o---o--X------?------------------------------M?B--------------------o-------B-----------o--X-MMB-------------o---------o---E---o--E-X?-X--X---M---o----?-----X----
------------------?-------X-------------------------------X-X-o--------M--------o--o-----o----M------o-------------X----o--X---?-----B-----------------X-?EX--X---?----------E?-M---o-o-----EE----------
---B---o-------X--o--X-----X-----------o?----------------o--B------------------o--------?-----------X------------------o---------------X-------X------------o------------------?----------M----B-------v
-------------EB---------o------------------X----o-----X-B----M-------E--Mo---M------X-----Mo-----X-----------M-------------B-----------?---------------E--?-----------------------------------B--X-----f
-X?-----B---B-------------M----o---X-?--------B---------o---Mo------------o-----------o----MX--o------o----------------------------------?--------------o-----?----------o---Xo--X-------E-X--E----?-X-f
--E------M--------X-------------B---------X------------M--B-----o-B--M--o-X------------------EB--o---------X-o-----X-----oE-------------------X-----------o---o----------------X---o---------?-?-----M-f
--------X----X------?------M--E--------X------B------------o-X-E-----------o-o?---?-ooE---------B--?----oX-------------------?-----B--E---------M-B--X-X--B--o---B-------------E---B---------o---------f
-T--XE---Too--T--X-XTBT-XB--MX-oo----X--|-o---TX-E---o--------T-T?MXo-T---oT--B-BoTB-?---TT--XooEo-----?--M-----B--B--B--MM-X?B--TTB?|M-To---?B---o----?---XX--?BTX?X--XET---XX---XM----Xo-T----B------f
----------T--BB-|-XXX--TM-E-----?-oo---E-o??---XTT-M--|-T-X----?X-XT--B------o-|T-XoB-o-T--T--TTX--T----?M|--o--T-ET--X|X---------XoTo-XT-B-TMo---o-B-E--TT-T--T-----T---o--TT---------M--o-X--oXT--oBXf
mB-?|TE-----TXB---?---E-BX-TTo----X--|T-X?-XB-------|-Xo----o-B---T-TTB|-XE----T--?---MXX-----EE-|---E----T--BT-?T-X-M|?o-------T----TM-EB-?M-oo---TB-o-MB----B--TTE--X-------T-?-T-BXX|-Mo-|BBTE---MB-X
XXXXXXX--XXXXXXXXXXXX-X-X--XXXXXXXXXXXXXXX-XXXXXXXXXXXXXXX-XXX--XX--XX-XXXXXXXXX-X-X-XXXXXXXXX-XXXXXX-XX-X-XXX---XXXXX-XXXXXXXXXXX-XXXXXX-X--XXXXXXX-XXXXXXX-XX-XXXX-X-XXXXXXXX-XXXXXXX-X-XXXXXXXXXXXX-X
