---E-oB--B------oX---?-----o-B---o------B-ETT??B-BX-X--||--XEo--XB---|-?-Xo-B------M|-X-------M-XX-X-oT-----T---|------|----EB-o-------?-o-B-X--T--|------E?---T-E----X?---TM--------B-------o---X------
-------Eo-XX|?|---M-|T|-oo-?-------B-?---|M--oX-MB--X---------E--?-------XB-T---XE-?|-T|----|------?-B-----XoTB----X--MM---X-E-------B---?-B-|-|-?|------X--?--B-TET--E|--------oMEBM---B----ET------B--
-TB-M--X-?Xo----X--To---EX-Eo-M-----|---Xo|o----E-E--M----TM----T--|X--?---?------B-------E-T----|o-M|--|------E--X|-MM------E--B-X----EE---X--T--Eo----TT|-EB---?------oT-----------oB----------|------
---o------M--Xo-M---o--X-----B-T---B-T---XMM-|M-E---M---EX----T-BX?---M----M--M|-E-------XB----o-TX-T--|-EB--?B---|oX------|oo------M---B-T---|-Mo-T-oB--------?------o------------T-M-E-T----BBE-o--M--
---TEo---E------B------X----M-o--------TB--T|--M---Bo|--T--BBB---|-----|-M---o-E-MXB-E----|X-E---BXE?M----|------------------B--X-T?-M-?---X--T|BM---?-?-T----|B-E-?XX--T---E--M--M--o--M-o----T----M-X-
---MB?-oXB-M-------BT--TT-|-M--B--XMT--o----M--MM---B----oo-MMB---?-MMoXB-E-----MEE|---BE?---M--------E-|----BX--------?-X--o-----o--B---X---|-X-M|-|--B---T-B---X---------o-|---XTE|oEBME-------B--o---
----?E-------|------X--X-M---Xo---?--------o-o-M-M-|-oM---E|-----X---T--XX-|-M---M-M------M--B-T--TB|---|---?----TM-o--?-E--E-X--E--M-E-----M-----?--|-----M--o--B---X------|-BB--T--?T-?|---o|T--|--X--
-----M--M-TM?----X------o--T-------X---B---EX-----|-X-E---X--B---M--?--Xo--X----B-----------X-E----o---Bo-X-----|--T----E|--------T-|B---E---X--E--B-M--|XXX--EoM|---E--M-?-T-o--M-B-M|-o--B-?XT-B---T-v
---|-?--M-|----T------|-?B-M|--?--|--M-|-M-?--X------EM-X--------|----|M|-T-B-T--MTX-|EBB|----|-BM-EM-M?---B-T-------o--B--TB?-M-M--Eo----X-XB|---EE--|-ETo---|-----?-T--?-B-M--?---X----B-----B--M--T-f
-M-B----|--MX-Xo-X-------|B-----?-M------EE--?-TM-?MB-|o?TE--|-E--|--B||-----?o|---|---XB--o-E--?-M--??-|-----------E-----|X--|M--|o---|--TBTE-----M?----B-XX-MMM-M---E--|-?----|-E----E-----o--oo-Eo?-f
-?BT--E-M-T-------M?---E-B--TB----------T------ToBB|T-o-MTB?-|----o------oE------o--BM---?-------X-?---T-MBXo-|--?B--B-E--?---oB--Xo-Xo--------T?o---?-B---T-E-T----T-?--T-----?BT---|?ET-T-T-o-T--|?--f
-|--BT?|-o--o-X?---X----o-Eo-E-T---T-EM|--B--ME----M---oE-o--M--------B----B-------|----MT-|------M-----|---T--XBo---------o-|X--------??TMB-----B-XBB-M-X-|---------------X-?--M-|--o-|----E-----|-ooof
--?ME---E-M------oME|----M-----TMM-----?--o-----?oM-----|X-o?-M?-Bo--E----T-B|EX----?-M-M|---Eo-M-E--------?o------o-|---?-|?--ME-M-?B-XXo-?-TT--?--|oE-?|-X-EB|--o--Eo--M------BX-----o--EETX-------oXf
---Xo--?-|X-|-----B---M---ToE-------?B-X---E--oX-T-E----|--|-|MT-------o?--|---B?XM-?EXEE-TX-------T------o---MX?-|B--o?---M-E-------?-------oM?-?X-?|--M----o------B-|-E----T-----?M-X-T-|E----M-BT-Xof
m|-?--?------?-----T?-Mo|----TX-------BMoT---X--EX?-E-o-------oE-T--MB-------Bo-----|-T-X------B?--X-?--?-T-E--ET--M---T?-To?|-----?-T---?---T--oM?o-|---?----T-M-?|--Bo--XB-|-----B-XB-|oT---|----E---X
XXXXXXXXXXXXXXXXXXXXXXXXXXXXXXXXXXXXXXXXXXXXXXXXXXXXXXXXXXXXXXXXXXXXXXXXXXXXXXXXXXXXXXXXXXXXXXXXXXXXXXXXXXXXXXXXXXXXXXXXXXXXXXXXXXXXXXXXXXXXXXXXXXXXXXXXXXXXXXXXXXXXXXXXXXXXXXXXXXXXXXXXXXXXXXXXXXXXXXXX
