-----M--MMB-|--T-o--o---X?--?---T|-----?-----------E--|--M-EBB-B|----ET--?oB?-----------?T|--BM---B---E-?-M-Bo----M--M--?------E---EBE----T-|X----?-----B--?-|--|T|BT?E-X---T--B-?-|M--?Bo-X--o-BT?-E-B-
----?|B------?---E-|---o---o-???---|-----?--X-T----M-------?--?--B-----------?E--MX-TX-----T-------M-XE---BT-----Mo-?--M------TE----T--M-M---M-----o-?--T---E|-E---T---------B-?---------E-XXT------XB--
-----?MEE-E----M|--E-|B---?-BE-----B---?T?X-----?--B-MX--?-T---o----T-?B-B--E----T?-o---T-----ET--X---Mo-ET-o||?---T-oB-T?-----T-M-BT--?--------BX-?-----oMM----Bo-M----|-M---E--T|----|?-o-------B--X--
--oMB----X-?--o-o----?TB-M------B-X-E----?T-E-T-ETT----------o---T---E-o|-------|T-M-X----B--|----E-?EETE--E|----E-o-T-Mo-T-oB--?---o-T?M--T-B---BT-BB---|EoBBo-E---M?--M--XBX-M----E-B----B-Xo?X--EM--T
--B-o---TXT-E----|-M--E-----MB----------?-To--oT--B--o---E----B?--|-o-o|oo--TB---E-|--?-------X?-Xo|-------B-----?E---|-----X---BX-X--?o--E----o----TB-TXT-------o---o-B-Xo-?-B---E|--M?--?-?-|X------|?
-|---M-X?X|---------|-|---M----|----T--MX----XBB-M-----|---XTBT--------BE----T--o-------E------EBTT--M-TE-M-||-------T-T-----M-XE-----oX-----|-|-----B---M----?-X--B---BX?oMEX---|-M--o-E----X-T-oTT-X--
---?-------|---MT---M-----B---M-TB---o---M-B-----B--o-o-------T--T-?B---T?---TB-X----X|---M------B-E-?-T---E-----------XB--------??-X------E-o---o-BB-||----o?X------|M---B---?-------XMo---X---EoT|-X--
------o--|----X-M-|---M-----------MX-----?---B-E-----T-|------?-----E---B-----M-B-----------T-oM----BMB---T---T|----------T-------MT--M-o?--T-----|----|----|---|---B-?-----TM-o------o?M?|-?E|-B-o---XM
-T-|B---o---B-----o--E---o--?-o--E-XB-?B--?-----?---XoM----X--TMEB-------X-?-o?------B---X-o|-?EB---|------EX--B-TM--|-B-EE--B--E---T-XX---|-E--EB-B-------?-T----o-?EMo-TTo|B--||-o-EoX-M--T-|---M---M-
--------X-|-M----|T--?XX-|?MT--M-o|-E-B-E-M----E--BBBM---ME||-?--|-X--BTo-M---E--M-o--|oX|--X-M?--o------E-BEX-T-MEo----XXM-------M----|----T-----o------E|--B---------M-|----E----??--?X----oT---o---T-
---E-o-||B---E--|-oM-X-E--oB---E--|o----EE----BE-MM-----E--XT-o-----MX-ME--B--M----X-?-----||---E?T------E-----M|--o---BM------M---X---o--?-?-------||------T?ooTB---------?----E--X--E----?--T-|-E-----
--oM--T-TT-----------T-o-To--M----B--MM---TEMM-----E--B-T------------------?-----M-----T-X-o|B--MX----?----EB-----T|M------B----T------X-|E-o-------o--------------T----XMoXB---o|o-------X-M-M---------
--|----BT--------oXX----X-B---o------BE-----------?------o-E--M-T--?E-MT-M---o-?---oX-BET|-T--B-|-E--o----XB-------o--|-X--MB-----?-B-------|--X--E-M-M---EE-T----|--?----|---?---X-B--M-M--Bo-B--B|----
--|-X--M|B---XB--E--X-B---B--o-----B--E--|---B-M|-E-----o-Mo-?-|?-X-----X|-----E-o------oX--M-B?---?---T|T|-X--------E---T-M----X-XM|-----?-M---B--?-MB--?T--BE-T--??B-|--oE-|?X-TE----E---|M-T?-M|E-|T-
-------B--M-----o-X-M-o-||---------M----|--?--XBo---|-B-T-TX-oT--o--|--B|--ET--EB|-|--BE?--o--|-o------|?--o--MM---B--|----M-?--|--|-ME---M--T--To--E----o--|||?---M----|XEBE--T----------E--E--T-|X-B--
-XXXXXXXXXXXXXXXXXXXXXXXXXXXXXXXXXXXXXXXXXXXXXXXXXXXXXXXXXXXXXXXXXXXXXXXXXXXXXXXXXXXXXXXXXXXXXXXXXXXXXXXXXXXXXXXXXXXXXXXXXXXXXXXXXXXXXXXXXXXXXXXXXXXXXXXXXXXXXXXXXXXXXXXXXXXXXXXXXXXXXXXXXXXXXXXXXXXXX-X
