------T--E-T---T-X--o-X-?-T-B-X---M?|-o-B------T-M--------Moo---TT?-----?--------T--X----X-?--M----?-X--TM---T--T-----X-T------X---E-----E---Xo-o--B---------o----oX-?----------T-?--o--T-T-?-T-------M-
--?XB-EM----M-TT-------T--E--X--o-oT-TE-T-----------X-B------o-E---?T---|-M--T-|TM??X---o-B--T--T---T-E----------T--------------M----E-----oXT------TBo----------B---------X--------------o----T-To|E---
-B---XT----X--Bo-----ooXM---Bo-?---oT-------TX----------T------MXE-oB--T---TTT--T-----X----B-----T-----o--T?-T-T------o---T-T--M-To--MMM-|----------T-o-------o--------T----ET-----o?T----To--ET---?T---
--o--|-T---T--X-Xo-------B--TX-X-Xo|T------X-B--T-X----XB--|--T------X----T---T-X--TBX---?X-------TX?---?T---T-T------T------BT-----X-----X-------------o--Eo-o-M--XTT-T-o-X|T-----------------B---T----
----X-|-------T-----M-----T----|TE--B---oX-o-------X|-B------B--B--X-B--?-X-?-X-o----------?---------M|-------TB--ET----M-XT---XB---o-o-TXX-----------|-?-?---B----T----o------X-------?Eo-?--TE---BoT--
-----TMBM--B-------E----o?---ToE----o-B----o--X---?---------o---------ET-----T------T--M-------T---MM-MX--------o-----T--------TX--T---o-T-B?-M-o-E----?----oo----|T---X---TX-o--T------T------B--o-----
-X----T-X----TM----M-?--?---------TT---X--X?--B-----E----B------------------------B--M------T---M---------M?X--X--E---------T-M------TBT---XX---|-o-----TX---B-o------o--T-M-T---TX-X-T-E--o------------
----------T---T---X---|o----E--X?--T----|-----T-----T--?T----X----?-?----------X-?o-------TM---X-------B-E--T---TT-----?-----B-E---|--X---B?-T----T-?B-MXXo------X-EET-B-----T-----T--M-ET---o--T--T--ov
-o---?----T---X---------------X---X-o---X-oT--------X--M|--o-o------o--B--|---?---------o----?---T------E-------X--|--T----E-TTB|------E----------MEX-----X-E-------TT-E----?------oT-T?-TET----T|-TEX|f
-----B--?-----oE-----X----E-X--|--T---T-M-----------T-Bo--------X-----X--T-----TEo----o--?o----EoB--M?o-----oT---?---T-------------T-----B------To--|-o---M-X-----T--------T-----To-----T-----o-----o--f
----T-M----------E--------?-TX------T----T----------o---E---T---T|--Mo----------?oXTX--T--------------B--BT---T------M-BBTT-------------B-T-----B--MX---T-M-----X--|?----?--M----o------?-------To-----f
---?--ooT-------X-T-T--------?T---X----M-----B---?-ME|----TB----X?----------B-BT-----X----oXXT-------Moo---oT--B----B--T-----|--X-----T-EM--|---E-o--T---?--o---E---MX--?-----?B-T-X---X-------o--B?-Xof
--?-???-?X---?o?XX--T-BBoX-o--?X?M-B--M?XBo?--B?XEE?-|---B-?-XB-MX-BXo-M-?XEM-B-BoX--XXB-oX-XXM|X-BBBXBXX-XXX-X?-|X-B-E?X-Bo--oX?-E-oB?B?-X?MM-?Eo-XX-BMMXM-o?X---BoBEXE-BXooX|-oXM---MB--?oXEMB-MXBo?Mf
--B-B??M?-ooB-???o--|??B-?--o--X-oX?B-X--XBBE-Bo?BM-B?X-BBB?X|BMBB-?-EBMMBTBEoMBB-Eo-BX?MM-XoBX?|Eo-XB-X?------?-o|-?ME-TMo|?oooXo??X?XoEEXEo?E-?-o-B-M--B?-BMXBBoBo-M----EBMMBMo--?X?oB-B-?X-M---MEB-Xf
mo-B?BB?B?-Xo-??oBXMXoXB-XXoEE?-ET?X-XM|-BTX-XMMX-XoE-BMX-B---T-X??Mo-X-B--BXBEBB-BBM-Bo?B--XX---X-MoBEBoBX?X-B?-o?|--?-XEoooBMX?-EM??M-oX-B?BXX-MB?X--X-XBX-XXXB-B-BEM-oooB|?XBBBTMX-BBEMB???-TX-MXM?-X
XXX-XXXXX-XXXXXX-X-XXXXXXXXXXXXXX--XX-XXX-XXXXXXXXXXXXXXX-XXX-XXX-XXXXXXXXXXXX-X---XX-XXXXXXX-XX-XXXX-XX-XXXXXXXXXXXXX-XX-XXXXXXXXXXXXXXX--XXXXXXXXX-XXXX-X-XXXXXXXXXXXXXXX-XXXXXXXX-XXX-XXXX--XXXX--X-X
