-----B---------B----o----X--------------o--------------------------M---o--B------X-----oX----XB---o----------------E-------X---------------?-?---------?--o----------XX-----------E-o-----M-B----E------
-----------------------M-----------B--B------------------------E-?-------o-------o------M------------MX-o-BE-------------T--M---o---X-----X-X-------------------Bo-----------------------B-----X?-B-----
-X----------------X--------o---------------X---o--?--o--o----?----o--------------XX-----B---------o---M----------?----M-----------?--------X?-----E-o---------------------------------------------B-----
----E-------o--X-BM-----------X-----------E?X-----------o-?------|--o-----------------------------EX-------oo--------------M---X-------------X--XM?--------o--B-------?---------------------X---o----Mo-
------X--------o--?-----------------MX-----X-------M-X---M-o---X-|---B-----------------M---------M-?-----X---?--o--ME--oo---XB--E------------X------?BB------------------?----E-------EX--?-------------
------------?------?--X--M----?M--M--M----X---XB--?-M------MM----|M--------X----------E----E-EM--o-----M---?X-----------E--------------------------------E-M-------------------o-------------BB---X-----
--------o-----------------o-----o-E----------E--o-------o?---X---|-X--X------B---?-X-------M--XX-----------X----X---E----o?------o----E---------------X----o----M?----E----------X------E-X-|---XB---?--
--?--?--------------X------------X--------X--M-oE--B-------------|----o-------------X---B-o-M-------------oB--E---------B-----X-----E---?o------X-?---------X----o--X-----------------X-----|--B---o---v
---X---------X-o----------oM-----------?XX-----------------------|------?-----X---M-----M------------------o-----------XT-------------------------XB-M--B--?----Xo-Eo-X----X----o---------B------------f
-----X-------------EBM--M----------B---------B-------|X----------|-------X--?o----?-----X-o-----------------o--o-X--BX------E---o----M-----X---X---E----M---------------M----M----M----------?-----oE--f
--?M---o---o--------X--------o-----------X-----------|-M--B-----M|--o---------?-------B--X-E-M-------o----------X----oB-------X---------------B-------X----?----------X----X-?--E?-o----EX------------Bf
---------?-----X------o--------?B--------|M------Eo-----|---X--E-|--------------M----------------E--o--------------------?--------X----M-X-----?----X--Bo-----o------------------------E-M--------X----f
------B----B-E-B|-ETo-oT--?----X?ToMBE--T|MX-M|T--Eo----|o--|---T-o-X--oX--o-B-T---XX--T--BT-To-o-----Xo--oT-M-X-E-----o--?o--T--oM----?--X-----EX--X-----B---o-|-?BT----TE-oTXT----?T-T--o-M-----oT--Tf
------o----E---T|--|-X-|E----E|-||-----|||E|-E||---E----E-E||---|------|B---X--|---EoT-|---|-|-T----o---M--|----|---Eo-o--E----M----?-M--o----T?-|--------------|---|--?T||X-|-EX|M?-|-|---|E-XM-|E|-||f
m-----X|-B--?|E||?B|-T-|----o--|||--E--|||o--X|-|B--o-X-T--|T---|o-|M-T|EXT----|--E-T--|-|T|||-|-|---M--E-------|||-|----E-------||?--|?----X||--|--E?--ET-|E|T-|--T|E--|||-E|B-?|---|----T|?---B|||-||X
XX-XX-XX-XXXXXX-XX-XXX-XX-XXXXXX-X-XX-XXXXXXX--XXXXXXXXXXXXXXXX-XXXXXXXXXXXXXX--XXXXX-XXXXXX--XXXX-XX-XX-X-XXXX-XXX-XX--XXX-XXXXXXXXXXX-X-----XXXXX-X-XXXXXXXXXXXXX-XXXXXXXX-XXXXX--XXXXX--XXXXXXXXX-XXX
