------------------o---M----X---X----oX---M---B---X--?-----BB-------??--------------o---------X------M----XX-B-X------------Eo-------X-------------------B--X------o-----X----o---XX------M---M?---------
-----------------o---------------------?-X-M--------o-------X--o----B----?------?--------X---------?--------?---?-B?------------------------Bo--B-M-----------B-----------?-----X-X--E----B-----E----oE-
------X-o--M--------BB-o?----o------B-------X-------E----?E----E------X------------M-X-BBX-B-----B---------------X----------?--M-----------o--o---?--------Eo-------o---------------B-------------------
--EX---------B-o--E-----------o---B-o--B---?-----o-------M-----M------M--?-E--------X---B--X--------E-----------B-X-----------?----M-----------o-----------------M------------B-o-------------------MXE-
----M----X-E--------------X-----------o------------B---------------E---X---------X------B-----o-X-o----X--BB----------B----EE-------------------o-o-------------------o---------M-?--??----------X------
--o-M-o------Eo---------?--------o--------------------------?----B--X---?---------?M-------------X---------?X--B--M----X-----------?B---o?X----??------------X--X-o----o--------B--E-X-o---Bo----o------
----X----B---B-------------??-X-Bo----------X--oB--XB---------o--o--X--------M-------------------X----M---E-----o-----------BM------------E-------XM-B---?----B-----------E----------B---B-----------B--
----E------M----?------------o-----------BX-?-----?------------o----------------X---o-----B-o-------------?--?----------X------------?B-----------X------?--o------E-----EX-----o------------B-o-------v
-------B--BE----E----------o-B-----X------XE----o----------------XE------X---------o--------E----M----Xo-B----E----?------Xo-----------------o--------------------------X--------B-------X------------Ef
----------------E?------X-oo------------o-----------X----------------X---------------X----X?--E----o-------------------------------?--BM-E------------X-----------X--X--?------M----?---E--------E--?-?f
--X---------X---------------------------------------o-B--------?--------------X---?-E--o--------------------B--M-----------X-?---?----------------B-?--------------------B--X--X-B?--------------------f
--?-----oM-----------?-----?---?------Xo---------------B----E-----X----------?----o-ME----X-------oM------------------X------o----------XX--------o---oX-----o---o--------------o----?-------B---o---?-f
-------Bo-----??-T-TX-T|?-TB----TB-o--TT-T-T--?-o---oo-T---?X---------------X-E------o----XT--X--XB-MT----X-E---------B-M-XE--MTEBT|B-----?-XoEXEX-EE--oM-------TTX----M?TXX---B---o--B----M?TBT-------f
---------ET--||--E|-T||--oX-|o--|E|--|||-|-||B|------|----X-?E-|XT-BTT|T||-T|--|||----X---?-|---|--|E-B|o-|-T--T--|---o|--|T-------|||----|-|---||XE-|-oT-|--o|EX---?|-----M--|-|----ET---|-T--|||--|-|f
m-----|--T--T---T-T---T-E---B||E-|----T-|-|T|----o--|||--?T|-To--|--EoMBE-----X-|T-E|T-|ET---|||||---T---BMM----|---X--o--?--T------M-XTX|?-B--|||--?X|-|T-o-o-----E--E-|--E---||-|o||-TXTX-|T--|||-|EEX
X--XXXX-XX-XXXXXXX-XXXXXXXXXX-XXX--XXXX--XXXXX--XXXXXX-XXXXXX-XXXXXXXX-X-XXXXXXXX-XXXXXXX--XX-XX-XXXXXXXXXXXXXXXX--XXXXXXXXXXXX-XX-XXX---X--XXXXXXX-XX-XXX-X-XXXX-XXXXXXX-XXXXXXXX--XXXXXXXXXXXXXXXXXX-X
