-------------B---X------?B----X-----B---------------o-o-E------------------------------------------------------o--------B---?o------X-----E--o------?---------XEX----------------------o--B-----------B-
----X-B-M----?--E---XX-----o------------B-----B--B-X-----X-o--o?E--XX-------MX----?------oE-----M---X---X---?------o--------------------------------X--M-----o-B----------?----?-B-----X----------o-X---
----------o---o-----M------?X--------------------E-----?--------Eoo------M------M-----X-X-----BE----------M-?o----------------------------------------o---o------------?----------o-o---------------E---
----------B----------B------o-----BoB--M----------------M-------------BMX-Xo-o------o--------------------------o---X?----------?-?---------------o---------------------o-----------------------------?--
--------E---------o-B-------Xo?---X------------------------------------B---X---X---?----------X----------------X--------E-------------------------X-----E-----------------?--X-----o--X-M---o--o-?EX----
---B--Xo-----EB----o----BM--------B-------X----o-------B-E----X-----M-B---X--o-----o------X-----------B--?--------E-E---------------XM-B-----E-----E--------?---------X--o-X-----o-X---o-----X--------B-
-----o-------o---------M----oE---?---M-X-?---E--------------oo----X--X-----------------------------o--X-----o--------X-B---B----o--------------o---------B-?-----------------E----X-o-XB-?---M-----o-o--
---------------X---------oX-------------------------------o-M-------------B-------X---o---X---X-B--------------------------?-------------------X-E----------o-o--------?----?----o-E----B---?-B-B--oE--v
---------E----X------------B-----M---MM--------M-----B--M------M--X?---?--?---------o---B--o-B-----X-------------M-o----------M----------------B------B------o----------EB-----M--------o--X-----------f
-B---o---o--E----------------------?---oBX------------B-----------o--M-M-----B----o------------E--o----------X----?--BX------o----o----X-----------B-?-----B-X---------XB-o-M--?o-X-X-----------XB-----f
--------o---o--?------------------o----X-o-X---------------?-MB-?----------oX---o-X-BoM-----M-----X---------o-BX----X------o?----?---E------?---o-------X-X------E-----B?-----oE------M--------------M-f
---B---------?----o--?-------------------------------X-------?-----------E---X-o-X--------------------o---------------B-E--B--o---------o-B--XM--o--X-----------oo-------------------BM----------B-X---f
---T--T?T-TX----?M----B---oEM---T-----o--------EET---------B-T---oo-T-T--?---TTTX-o---T---------B-----------TT-B?-TT-----T---oT---T--TB--M-----?--XT----o--T|---T------T-------o-?-M-XETX-T-T-|T----o?-f
-----B--X-------MT?-TMM----o--o-E--T-MT-------------------E----?T?----T--M--T-------------B-|----B-|X|-o--B-X?--X---TE-T-----BT-X-B----|----T----------Mo--o-?-??T--o-T---B-?--oB---E-o-XM--T----TT----f
mo-BX----?-E--XM-----XE--T----MBBo--------X--------M--T---B--E-T---E--?--X-TT---o---T------TB------B-T---T-E-T?-T-?--EXM-?o-X--X-----X-----T-o--T----o----T------TTEB-Xo--o-T--o?--BB---B-B----BoB--X-XX
XXXXX-XXX-XXXX--XXXXXXXXXXXXXXXXXXX-XXXXXX-X-X-XXXXX-XXX--XXXXXXX-XX---XXXX-XXX-X-XX-X--X-XXXXXXX-XXXXXX-XX-XXX-X-XX-XXXX-XXXX-XXX-XXXXXXXXXXX--XX-XXXXX-XXXXXXXXX-XXXXXXXXXX-XX-X-XX--XXXX-XXXXXX-XXXXX
