-M?--------------M-------------E-o--------o-----o------?-------M---------------------------------E---E---------------------------M-----------B-------------M--------o----------X-------BB-?----B--?-----
------o-o----------------M-----------B-------------------BE----?-----XB--------B-----E--------M--------X-----------?--B----o------------------------------------B-----------------B------o---------X--o-
-M?---X--------------------?---------------oX----M-----------X----------B-------------------------X-------?--------B------o----------------X--M----E-------------------------------------M------------E-
---o---X---B---------------X--------?-----B----------o-----------------E----------o--------------oX-?o-----o---------------------M-----o---------X---------X-o---------------?--------------------------
-----------X-----------------------------------------B-----B----X----------X-E------Eo---E---E--oB-----------X-------------o----?------?---------------------?---o-----X-------X---X--------------------
-E-----------------------XX--?-M-------------------------X------E---M--------M---M-M-------?----------M---------------M?----------X-------X--oX---------------Xo-X-----?o--------------------o-------E--
-o------X-M--------------------------------o--------o------------XB--MEEo-------?-------------------------E----------------?---X----------XB-------o-------X---B-----------EB----X----------E?-----B----
-----------------------------------------M----------?----X------------o------------------------------E--------o-M------?--o------EX-------------X---------E------------oo---o-----o--------------------v
-?---------------------?----B------------B---------------B--EM----------------------------o-------------------X----M------X----o-------M-------------------X----X-X---------------------M------?-------f
---------X-----------B-Xo--------------------X---M---oXM-----X-X-------X----------------B-----B?--E-?----B?---X---------------------------------------------o-E-------oXo--------?----------X---X-E----f
--------------X--E-----X----B---------------X-----------------------X------X----------------X---?--------B------------X------------------------EM-----------?-----------------------M----------------M-f
-------------------o------XB--------E--------o---------------------------------B--o--------?--------o-o----------E-X--?----------o-----X-----------E------E------XE-B-------M-XB-----------------------f
-------oo---------------B---------o-Mo----?-o-------?--E-----?------Bo--------X-------M-X-oX----MBE--------------?-X-X-X---o-B---M?--o-------------X-M-------------------------EX---Mo---o----E-E-X----f
------EM-----------------T---?---M--To--E-T--T-----------------TT---ET--Eo------E---B--BET--?o---B-----X-T----E--M---E---TX----T----E-TE---E------------------T---------T---T--o-------T--TE---?---T-T?f
m------------------------|--E-----B-|E--X-|E-|X-----TE-T----?--||--EX|------T-------X---E|X-o------------|--T------X-----|-----|------|---------E---X|---To---|-----------------B------|-B|B------B|-|-X
XXXX--XXXXXXX-XXXX-X-X-XXXXXXX-XXXX-XX--XXXXXXX-XX-XXXXX-XXXXX-XXXXXXXXXXX-XX-XXXXXXXXXXXXXXXXXXXXX-XXXX-X-XXXX--X-X-XXXXXXX-X-XXXXX-XXX--XX-XXXXX-XXX---XXXXXXXXXXXX--XXXXXXXXXXXXXXX-XXXXXXXXXXXXX-X-X
