--T|MXBET-?X--BT?-o--B-BBT----o-?-Too|o?Xo--XXX-oM?XMMTT-|-EE-o--MT-B-|B?BTT-TTE-M----XM-TTE-oTB?Xo--?M|E-o-ToToX-XXT?X-oEMX?|TTT|?-oB---|-To-T|-E?--oXTB|?-T--MoE-oB-TBE-T-|T|TB-?TBB-|?TT--T-T|o-To-T-
-E--ToXBT-TX-BT|TTToTTToMTTX-T--BX|TE?X-T?TEEEoo|---o-TXB|X--EX-T---XEo|B----MToooT--?X-TME-ToT?TT-X|-E|?-BMoM-TTo-?XTX-X?T?--M-|--?oo--X-T--|ooE-TXM--BBo-BoXoBo|---E|--MToTo--oXoXEX-?-X-Bo--|---X-TT-
-BB-TT|?MTBBE--XM-X-oTo-M-X-TB?-T-?-oT-o--TX-B|o?ToTT------BBoBMXTB----|TTToTT-Too-ToXoXo?E-T?-BT-?T-ET--T-T---E-o---BE--BXEoXMoM-oM|T?X|XX|o-T-TX-----X--ToXXXXT?-oB-T?ooMX||-o-X-T---ToEoETTXX-ET?-BM-
--T?-MTXT-TE---oT-oT-?-M?T-oTToT-EXTX-ooTBooTToTTTTX-o?-XTTT-o-T--TTEE-BB?T|XooET-TB---oooTTETo---BT?T-X??o---MT-BT-BoXoTTT-?TXMooE|---XE--TXTXX-M---o-BTT-M-oX---oTT|ToT-E?BMT?-XX----EXB-|BTT-B---B-X-
--TM|XXBX-TTET|-XE-MX-o?-o-X-?T-TT-XXT-T-T?T?TTX-B|T-BTT-XoT?--?-X-?M-BM-|T-X-XB-T---?XEToT--B?o|X-oBoXo-T?o-X-TET---XX|MoXoo---E-B-XX-Xo-TX-T--?|T?o-o-ToT-M-o-?TX-XooBoM?o-TX?TB-?T-E-T?oT--M--T-XXMX-
--E--E--B--oXTT-B-o-MTBB-?B?BM--TBTooETM----|M-TBB-TTXT-o-E-o?-B-TBBT|-ETBT--TT?XoXTTT--T-Xo-?T-oT|--TT--?-XE?-X|XEM--TT---|M?-B|Xo-T?E-o-oXEo|?-o-E--TBB-T-BM?Xo-XXT-B?TM-XoXX|X-M|-Bo-?B---o--BBTT--?-
---T-TBME-ToBX-XMTo-?-XMMM??M-Eo-ET-EoXBT??B-oE---??-EMo|To-ME-T-X-oX?-TTXXEEMT-M-X-T-TT-XoT---XTXT--B-T-o-?-oT-X-?BTM-M?T--T-XXTTMXo--XTTEo--?oXX-oE-EEMo--oET-|--T-TXTE--o-B?-B-B-TB-oT-TTXXXoXMXTBTX-
-XoEE-TB--o-XX?X|MXEM??---BB----o-oT-BoMTEo?---X--??X-MoE-T--T|BTTX---B?X-TTX-oEMX|-T-?-XT-XEM--?T--oT-BTTo-XTT-|X---X??ToMTTBMoXBT?EMBTXo---X-T-XoTT---T-ToTT-EMT-----ToTX--T?-EEo-?T?BTXTTT-B----ETTTv
---ToTTTX-?MEMMT-X-E-TTXEoTX--T-|T-Mo|oTETEM--T---EEB-Xo|TT-ooB-X---T-ME--B--??B?-MTE-B-TX-X-oX--|-|B?X-Xo-XX-?--XEXM?XT-XTXB-|-E-XE?Xo??--M--EToMT-oX---o---XTBTBM-oMX--X-Xo--TT---ToB--To?-o-oEM-T--Xf
-MTMTM-EB--X--?T-ETT-TTMo?B?-X-T--X-o-T-T--X?o--|?-T??TT|?XoEXo--M?T-T-?-?X-T--?T-?ET-MEo-B--Xo-o-?B-E-|o-XoT-|-oo?X----MM-TM?-|TXT-T-E-?-X|-|XME---E-|?EX---oTX?-??TT--E|oEETB-BBTMMXXB-T-To----MTT-TEf
-XXMTBo-o-E--TX---T-TT-TMT-o-B?ToT----B-T|T-T|-o---o?TTXTT-XT?B-T?B-?|TTT-M--X--E-?TXX?M--o-B-TToXoo?T--TTT-B-MTTX-?ooTo----oTTEo-T-T-o-To-XXT?EX|---MXXBE--M-oEoTTT--T-?Xoo-T-T--?--X?XXTBMoXT-?XBoBX?f
--oBT-oB-T--X---BT-?XT-X--o---XBoX-XTT-XX--XTM--BBo?X-ooM--?B-XX-BT---XXBT----oT--o?TTE--TT-T-oTToB-E--B-o-oTMTTXoT---X-BXT---EXTTXM-oX-XT-TTX--TXBM-XM-??--T-?-TE-EXTT-BT-|oX--M|X|MX-EoE---|B-ToEoo-Tf
-TBoB?---XMXo---M?-?-BE--?-ooX??BEX?---XEEB?XM--XM-oB?--XXXMooo-o?E-|B?X-----E?X|XBT?B|M-MBBM-BX??B-MXEX---MBo-B-BB-?XEooXX-o-E-?BoX--|XTB?B??--?X---?X-o?X-X--X-???BBo-BEEEM?-?M-?X-M-o--BEBX---oB-?oEf
--oB-?X--oBBo?------XXEo-BM|?E--?B-EB-oB-|-?-XT-X-BEEMEMoMX-XMX---oB---XB-oXMX-?XXo-oXoooooEM??M-----oB-XToX---B-B-oBXBEB-X-X-BXB-XX|BB----oBMB-?-oB?EBo---oM----TB?MXX-ooo-BXM|-oXM-M-BXE-E----X-XMEXXf
mBoEBMM?Mo?oBo?o-M-o-|-B-TX?XX-B---MM---X?|-X|?XoM-M-E-MB-|Xo----o-ME?B?-oBMoXBMXXoB--oo?MTXXX-MXM?E-Xo?B-BoTBXoM?X|TXMoX?Xo?o?T?XoMoM|-o-ooBMB--XBB?oXE-MM-MoXB-?|M?oEM--ETBB-B?E?EB-MBBMTXBB?-?B-?-B-X
XX-XX-XXXXXXXXXX-XXXXXXXXXXXX--XXXX-X-XXX-XXXXX-XXXXXX-XXXXXXXXXXXXXXX-XXXXX-XXXX-XXXXXXXXXXXXXXXXXX-XXXXXXXXXXXX-XXXXXXXXX-XXXXXXXXXXXXXXXXXXXXX-XXXXXXXX-XXXX-XXXXX-XXXXX-XXXXXXXXXX--XX-XX--XX-XXXXXX
