-|B-E|M-B---T----X-B----T?----?---------X-----E?-B-|--?-?-E-Mo-?---X|--------E-EXB--|--?--|-?---|-?---|XE----|E-B|-B------?T--|--------|EM---M-----?--E------M-----X------o------?B----o-B----------BTE-
---TE?To---M-|---?-|B---M-E-X-o---?-EM----|E---E-------------M----E---o--------|?o--T----------E--------X-|---B-----o----ETX-----Eo---o-EE---B-BB-E|--------oT-?--|------o----X-?X-M-----------------o--
-M-oE-----M-----------Eoo------------EoM----Bo-E---B----------------------o|-B-------X---E--------E-----o--X--XE?--E-B--|-------o-X-o----------X----E-----o-----------M---------M-B------?-?--T-X---|o--
-------o-E-XXX--------M---XBM--TX?-?ME--?-?-MB----EX--T---|E-|----B-E--T--o---To----E--XX-----E----|-o-------X--E---E-X---|-----M|-----------------X------TE----?--M---------??----------|------X-------
-?--BE-o--------M-oM----------X-----o------TE--T--o-ET----X-------------------o---------B-----X||-E--?||--------T|-?|--E--------X----|-o-o--T-----X------------T-----X-E--X|---------?-T-|--o-------B|--
-Xoo-------------B---------o---E------T-----?To--oB--------E-BXE---o------o-----?-X---M-|?----?--B------Xo---BE?M?-o------X--B---------o---E-MX-----?--B-----?E--------o---B-------o-|-?E--o----X----|--
---|---X--TT-----X-||------------------M---?B|--|--o---?-MT------------B-oX-----?-------?-o-M----oM-X-MX--BoX----M------Mo---M--M---T?----------MM|-E----T--E-|--X---------------------M--oE------------
-o----B-X---E------?Bo---E-EM---E---oE------Eo-----?T------o--o-M-?--E-----------oE---|X-?-M-----M---X--E|------|---E---|--B--X------M--B-?X----o---EM-|-------o-----o---Mo-T--X--E--?--EE--Too--M-o--Bv
---oB--T-X---------?---XM|-----MX---|------|-----------X----o-?----------MX----|ME-E-E--------XB----X--o-T-B-?-M----?--X-E----------T-o?-----B|--o--|--E---XTE-|-?-To-------E-------B----T-----------B-f
-X?----B-----M-o-M--|?--X---BXT-----o---|----E|------------o--------E-T-----------E-?B-||-T-M-----E-M-----?|-MMoX---M-------|----B------------|oE-E----T-----?-----|-|----------------E---XM?--E|---BXof
-?--T-|----?B----Mo--?----------TT----------T-----MT-------T----BX---T----------E|---oXXM--------To|------|-M|---|-------X--?--XX---T-B-----M----M-|-Mo-MX-o--B-MM-?X?----|-B?TXM?----B--?------o-?Xo--f
--?------oB----E|----B-E-----M-B-----M-----E-----B--T--------------o------E--?T-EMB---|-|-M---------E-B---o----------o--TB-E--?------BT-----B-----X---X----T------XBM-----E---MX-|------E--M-|E--o--X-Tf
------T--o--MX?TM-|--E-|--|X------X-----?--E-|---------M---T------E-E--------|-X--o?E-X-T--|---B-E--TEM--B-------T--M-X?X--M----XE--|--E|-----------M--X?XXo------M-M-------?---?-Eo--M-o-----------o--f
----------B--T-M-----M---B----|--X-MX?--o---T---?E---|---M-----T--o-B----B--BXE-E------------------B-E--E--?-M-o-X--------XE-?--B-o-|X--o--T--T-|M-------o---------------------------X---?-------TB---?f
mM---o-T--o----TX----X-o-T-|-----o---T-----M----------------M--|?--B-------o---B-|--E-------BXo--B----o----?BX--X-M|E|----o---X------TT?---o----?---|---X-T-------|------T|----Eo|----------------E---?X
XXXXXXXXXXXXXXXXXXX-XXX--XXX-XXX--XXXXXXXXX-X-XX-XXXXXXXXXX-XX-XX-XXXXXXXXXXX-XXXXXXXXXXXX--XXXXXXXXX-XXXXXXXX--XXXXXXXX-XXXXXXXXXXXXX--XXXXX-XXXX-XXXXXXXXXXXXXXXXXXXX-XXXXXXXXXXXXXXXXXXXXXXX-X-XXXXXX
