-o----XE--XXMBBB-oB?-?-----?-Bo-----M-------X--?B-o-B--o??-X-X--B--B--Mo---------E?BXE---X-----MM--B--X---o?---?--oMoo-o--X-M---------X-----?-----XB-----------X-o-B--?---MEoB-o--oB-EB----BBo----XXM---
----?--------B-EXMB------M-----?--------B-o--X---E---M-------XBBo-o--MB-----E----?-M--X?BEEXX----X-B---o?---M?X?B?------XB---M?--ME--B-Mo-M---?--E---M--?B-?M-------X--o-?-B-----M--B-X--BM---?---MB-oE-
------?oB-E--o--Mo--M-X-Xo---?-------?--B--??-Mo-------?----E?M------o------BBX-X-X---?Xo----o-E--B-B-o-oXo--B-----X-Mo-o--------o-M-MBoE?-?-MB-----o-E-B-X------M--?-----XE-X---E----?---------o---EB--
-MoEBM----EM-?--o?--?-Bo-B-?---------X---X-?E----?---oo-------?-BE-o---?--B--B-----------MMM--X-XMM-XM-E-----o-M--B--E?-XME--E-XM-----oM-o---B??--M-?-B----oB--X----?--X-o-X--X---EXX?-o---X-XEX------?-
--B----?BM---?----B-MB---E--XE--B-E-Bo--?---XX------EE-------oo--X----B?X----o--M-------oo?----BB-E-----B-B--X-Bo-?------X---?-X----Xo----------M-o-B-----B?--------oM?--BoXoB---E?---E-BX?---X---??ooX-
-----o-E---E-?BEXM-----?M-E--BE--M--oB-B--?M--------MM?-------o-----EBoo----?-B--B-o---M--------?E--?---M--E?M----EX--EX-o--?o-?--XM---?--?-------------BE---X----B--B?--X----------X-----M--------M----
--------B--E---E--?B---EEE--?o-B-B--ooE?-?-B--EE------E---o----?Mo--EE--B-X-E-X--M-B----E----M-E-?-----?E-B---EBME-----B-o-MB-?---X-E-XB--X?----o--o--------oE--o-BB-----?-M-----??-?XB--X?---X----oMX--
-o--?-o-??M-M--?-?--?E----M-X--B-----X-M--B---M--?XX---B--o-M--ooEM?-B-o---X?----BE------------?-E---M--XXXM--BB-----o--?X--------o-oE---?-o-oo--?-B-E--?--??o--o-E-X-o-o---EM-----M--X?---BE---B-?--?-v
-o-MM---M?----B-Xo---B-------Bo----E-M--B?-oX?E-M--M---E-B-MMEo----B-----B--?---BE-XE---?------M-------E-------?E--oB--o--EE--?M---M-----M------o--M---X-E--MB--EM-----o----B-E---B--X-M----oX-M---ME-Bf
----XMB-?------Xoo--------------------M----B--oB------X---M--Eo----------E---o-XX-?---B----X---?---o-------EM-o---BM--X--XMX---o?X?-------??BEX-E--B--E--X-M--XB--oM-o------XE--EBM-------oX--oX--X----f
-M-MM-B?-?--?BMM-?--BX---??-B------BoX---M-o-B-?----X-X----?M---?-o-B-o--XB-o-X-o----B-------X-X--o----M--??X--o------E--------B-----XBE--X---X-?-----M------------XE?------?X?-----?---Eo-?----?-?--oMf
--Xo?EB-----BE--XXE----??----?--X-?-X--BEEM-E-----BM--?M---X--E------o------E------o----X-E---X--X?-MM---X---?-X-M?-------X-------X-MX---o--o--BB--B-----B-X-------E-------?--B-E----------M-MB--X-X--Ef
-----E--o----M-o-?E---BX--------------E-------B-B---M--XM-oM-Xo--??--------?-?--B-o-B-?----B------M-----E---?--E-XE-oB----XM-oE-M-X---E-------?X-X----B--oo--?MX----X-------EBo--B-----?---------o--E-Bf
-o-E--o---X------?-----B---X---ooo------E---o-B-----M-MM--E-B-M--?M---M----oX---o-E---oB-----?-oMM---M-oo--?B---?-E?-?--M---------o--M-oMB--oX--Mo-M-?-?-o-XBEX---B---M-?--EM???-----E------B---?---o--f
m------------------------------------------------------------------------------------------------------------------------------------------------------------------------------------------------------X
X---------------------------X----------------------------X----------------------X--X---------------------------------------X--------------------------XX-------------------X---XX-------X---------X----X
