---o--B-----X?---------oX-X?----B------X----------o---------E--------?--------X-------------------X----------------------E---M---o-E----Eo---M-------------oX-------?---B-------------------------------
---o----------------o-----o--B----------------------B--B--------MXo---------B---B------------?----------X---------------M-----------?-----B?------M-----------?----B---------X-o---X--M---------o-----o-
-?--------?-------X?E------X--X----o------------------?-X--o-----------------o--oo?--------B-----B----o------------o-X-----?----o-?--E------o-oo--o----------------------??--B---------------------X----
--------Xo---------?----E?X-o---XB--------B?------XX------MB----B-------------------------------o--------o--------o--B---BX-E---------E-------Mo-?---------?---------o-X-E----X-o--oE-----?------X------
--?--------------o---B-?o------------M--o------------X-o-?---------------------E--X------?-----?------X----------------XB-----X-M?------------MB----------------o-XE---o---------o----------X-----X-----
-B-------------o-X----?-----------XM-------------o--?-----?------B-X----B------------------------------M------o-----------B----E--?----B----X-------------o-X----M----------E-oB-----B-X---X--oX--------
--------M-o------o----------------?---M------B--Bo------B----o----X------B----B------B-------------X--------------------------M----------X---o-------B-------------o------X---------X----------M-----X--
--------B----X-?------------?-E-E--?-----B-----X---?-----o------------?--------------XE-X---------o--------?-M----B--o--o--------X---M-X---B----------------o--X-----o---o-Eo--------------------------v
-------B------o-------------------?-B-----B------E-B-----------------------------------o----E----B--o--------------?-B----X-oM------E---M-E------E----o---?---------------o------------o--------Xo-X---f
--B--------E-?--E-----o-----M----X----B---------o--X----X-----E--o-------o-o------o-o-------o------------E-------------------o-----------------?-X--------------B------------oB-o----X---o----E---o----f
-X-----------M-------o--XX-------E-E--------------o-B----------B----------?----B-------------BX--------------?------X---?--X------------------o--------------------------?-------?-------X------------?f
----------------------o--------------------X-----------B------B-------B------o--X-----------o-----X--------B-------------?--o---E-----X----X----o---------E------------Bo-B------------XXE---B-B---X--?f
------Xo-Bo?---?------XET-T--XT-----TX-T--o---|-MXX---TE-BTE--T-----To----E-?----TE------T??---o-X--T|-XT-TTT--TXB-?T-----|MT---------T-o--XX--BX---?----TET--oX-MM--TBT-o--T----T--TT----?T---T-T----Tf
------|--|-T--X|---T--|||-TT--|Mo|M------?-|-?--M-|---|E--------EBEo-|||--E|-T-X--------T--Too-||EX-E-B-|--BT-T|-|ETT----o-T-M|-E-?--T-|-TT-|-||-T---||ET|---|--||oT?|-E-T|B--oT|||B|----||-|||-|-o--B-f
m------|--|----|BT|-||-------E-|--|---|-|--To-XEBE|--X-|X-T-||-|-|TTTo-|----|M-BX--T|||-TT-EX|---|||-E|--|------|----|--X|||--|--E-|--T--|--|---||-M--|----o--|T-B-|---T|--XX-|||||||-oT---|--T--|M--||X
XX-XXX-XXXXXXXXXXXXXXXXXXXX-XXXXX-X-XX-XXXXXXXXXXX-XXXXXXX-XXXXXXXXX-XXXXXXXXXXXXXXX--X-XXXXXXXXXXXXX--X-X-XXXXXX--XXXXXX-XXXXXXXXXXXXXXXXX--XXXXXXXXX-XXXXXXXXXXXXXXXXX-XXXXXXXX-XXXXXX-X-XXXX-XXXXX--X
