------X------------------------o------------oX--E-------------X------X--------------------------E--------?----M-o-----X---------?B-----------B----B--EE-----X-----------o-------------------X---M-----B-
---------M------------------o---B--------------oo--M-M--------------------------------o--?--------E---X-----?-----?--------------------------------B-------------------------o--------oB-M------?-------
-M----?-------o--------o-------X------X-E-------o---------o-?-----EX---------------------?-------?E-XB?----?B--------X-----?o--X----------------B-------------E---X-------------X-------E--------T------
---?--M--o--?-------X--M-------------X-----------M--o-------------------X----B----------?-------------?-X-------X----------E-o----------?--X------------?------------B---o----oM--------o-----o----X-M--
-----?---?---X-E------?X-------B------o-M-o-E----------E--B-------X-------------B---oo------B---------?-o-o---oo--XB-X?--?X--o--?-o-----------------X----------------------BBX---------B----------------
-------------T------M-------------B--M--------oX-----o-MX---X--E-B-B------o------E?---?-X--------------------o-------X---E------B---o-----o-----B---------?-----B-----------B-----E-------X----X------M-
--B-------------------|---ME------X----------o-----B------------------X-o-T------M-M---X---EE-----o----E--------?-----------o--X----o--E--X--------------|----------------------o------X---X--E----E--o-
--------E----M--------|-----------M----BX--------o--------------XX-------------o-----|-BE----------X----------o-------B---E-----------------o-E--o-----E-|X--?---B-----------XM-----o--------E-M--o--X-v
--o---------M---------|-------------o--B-------------E----------------E--X-X---------|-T-----E----------------o------o----?---?-----M--------M---B-XX----|--o---?--------M--------------M--E---------o-f
-----o?--------M--o-------------X----------o-M--------oM-----M-o-M----?---|--?---------B-X--XB-------?------X----X-------oB----------------X--B--X------?-o-o-X--------?-----------o-?-?--------|o-M-X-f
--|---X----M------------------------BM---?-o--------?-----X?---X--o----E--|-X-----o--X-B--XM----BME--o-------------E-o-?-------------------------E--------------Xo------------------------------|------f
--|------|-X-B---o-----------o------------B--------------?-------o-X------|------oX----------oo---------|----------EX----E-------------?------X-o-----o--o---------M---?-?---------?----X-------|-----Ef
--|-|-X-E|-E-Bo----o-B---T-T---BT-----ETT-TEB--TXTBTM------MT-o---TB-B-T---?-?------E-------T-|-?-o-?M--|-----X?-M?---X--|--XT----T--M-X--T----Xo---||T--T----B-?-------------o---?---?-------B-|B-|--Ef
--|-|----|-----------E---T-||??||-X--o-||E-X-?---|-|-----X--------|-----E----------M----T-|---|---XE-T-T|--T|-|-----Eo--E------|--|-------|X--T----||||T||---M?TE--T-|---MB---------|--TX-------|-T|---f
m-|-|-M-||-||--------|T--|-||-T||---E--||------E---|-?MMTE-|------|------o----------B-B---|---|----B-|-||-T||||---?--?---||---B|o-|--T--E-|o-E|--X-||||||||--T-||--|-|X--|-T--E--E--|--|----E---|-||oE-X
XXXXX--XXXXXXXX-XX-XXXXXXX-XX--X---XXXXXXXXXX---XXXXXXXXXXXXXX-XX-XXXXXX-XX-XX-XXXX--XXXXXXXX-X-X-XX-XXX--XXX-X--XXXXXX-X-XX-XXX-XXXXXXXX-XXX-X-XXXXXXXX-X-XXXXXXXXXX-XXXX-XXXXXXXX-XX-XXX--XX-XXX-XXXXX
