-----------------XMX-BB------E----------------X-E-------------X?-----X---------------------E---------------EM-M-----------B-------------?---E--------X----X--X----------o-o------o--E---------X-------M-
-E---?----------X--------M-----?---M-------X----?------M----X-----E--------------------B--X----------------------?XM---o-------------------?---X---------------E-----------?---X-X-X----------o---?-----
----X-?----B-----o-----ME--------------M-----------oB---X----EM---E?------------X-?----X-?----M-----------E?-------------------X-------------------?B-??-----B-------B----E-------------B---------------
-X-?M-M----o-E---------?---------?----------B---------B-EX--------------o---------------------------B---XB----------B--?-o--------B---MX?-------------X-----?--M----------X---o----------X-----------o--
--------X-----B--------?--X----X--------B---Xo---------------------------?o-----------------?--B----------o-------X----------X------M--M-------X------o--o-X------------------------E---X-------o-------
-o-oX---------------------------------------X----------------M--X--B-E-----------oo-X----o------M--X---?------------X----E---------B--------------------------o------B---------------?o--------B--------
------E---M----oX-M---o-----X-------------------X--B-----X---------E---------B----XM-----X-----------------B--------o--------B---------X----------o-------o--oo-X-o-----------------------------Mo------
---M---X---B-o---o-B-X------BE----B-----------EX--------------oo-----------------------?B------BM------X------------E----o-------o----oM--------o-X-------X----B----M--------------o-----------B--o----v
----------------XB-------?-------EM--Eo------o---------X---E-?-------------X---------------o--------------------------X---?----o----B--Mo--X-----------------EB-------B--------------------------------f
-----oEEM------------------------------?---------------------M-------B-----E-------------o------B-------|--------E---------------E---------------X----X--?o---------------------------X?--B-----X--o?--f
-------E-------??------------o-----------?X-----X-----------?o--?-----XX---------------------------X---B|--------------------B-------------------oE------------M---------o--------o-----X---------o----f
-B-------|----o--M-M-------------------------X------E----?----------------o-------------E-----X----X----|--E------------------------------------------o--o-----------------EX----MB--------------------f
----|--ET|TX--ET-TT-E-------E-----ET--|--o------T--|-------T-----TT---|-T------BM---E-M--------M-TTXMo-o|o---M--o--TT--X-E-o-------T--?---T---B-T-X-BT---o-----------MB--oM-T-E--T-ET-?MX-M?B-------B--f
--------|||X|--|T||?-TE--||M------X|--|-oT|-o---|--|T--|-o-||-B-T|---T|-----T--E--|-------TTE---o||o--|-|-E-----|-To|-|-E--?----o-||------|---T?|----|--T------------T-M----|----|E-|---|X-|-E--o|----|f
m------B|E|||Mo||||--|---|M--o--|---E----||--|-|-||-|E-------T-X-----||T|-----E--B||--B----|-E?--|||--|o|----T|-|-|-|o-T-------T--||----E-|T|-|-||-|X||-|||--?-----X-T---E--|?---|-T|--E||-----|-|o-o-|X
XX-XX--XXXXX-XXXXX-XXX-XX-XXXX-XXXXXX-XXXXX-XX---XXXXXXX-X-XXXXXXXXX-XXXXXXXX-X--X-XXXX-XXXX-XXXXX-X-XXX-XXXX----XX-X-XXXXXXXXXXX-X-XXXX-X--XXXXX-XXXXX-XXXXXXXXXXXXXX-XX-XXXXXXXX-XXXX-XXXXXXXXX--X-X-X
