---------------------?--------oo----------?-----M-----M---------E------B---o---X--??-o--X?-X-o-EXo------o--X---------B-B------------?-----------E--oM--------M--------------------------XX--------E-----
---Xo---------o------X---------B-o---X---?---B-B-----------oX--B---------o-------o----X------------------------X----------E-BB?------X---B----B-----X----?----B-?-o---------M-----------B-----?---o--o--
-------------B----------Mo-?---?---B----B---------E--------M--------o--------------B------------------o--E--X--------X------E-X---X---o---?---o----------B-----o-?---------o----------?-E---------B-----
------B-------------------X?---X---E-------X-----o--------------B-----?M----------------B------E---o-------XE---------------Xo-X-------X-o---o-o-------MMM-------------o---------X----------------------
--M---E-----------------B----?o-M----------------X---------------------M-----o--B---------X---E--o-----------X------E------X--B------------?---------------o----o---X--?B---B----E---X-------------X----
---E--oM-----------------XX------------X-----X-----------------X-B------B-----MX-?o----o-o-----o-X----oB-------?----E-o-------------------B-M-------?---E-MM---E----X-?---------B---B----B----------X---
-----M------?-E------?----X-----o-E-X----------?---o-------B----M---X-?---------E-E---------------------M-----------o-B--MX-------?--------------------------o-------------o---?---o---------------B-M--
--o---------------------E--?-?--M----------B--X-------B--Xo-M-------oo-----oo---?------E----M-----------o-----B-------X-B--M----------------------BX-oM---X--------------------o--B---o-------?-B------v
----------?----o-------M-------------------------------o----B---B---------------------X---------?-----o------------------o-X--------M---E-X-E-------------------M-M-o---E--X------------M--------------f
------?--Bo------X---------o-------------------------M---E----?-M------------o-----------?-----B------B--X-o-B-------------X---o---Mo-----------------E----X-------X------B---X---oX-------o---o-------f
---------X------------------o-------------MX------------------oB-----oEX---X----X------------------?-M--E-------o?-----------------------?-----?-----------o--E---------M------------o----X-----o--E---f
-----o-------------o----X--X--B------o-----o----o-X------------XB?X?---o----o-XB---?-------M?-------B------------X---------------o---?o---M---XX--------------?--B----------------o-----------o------oEf
------B-T?--T--TXX---Xo--o-B---?-E-------TT-ET-X--oE--B-Bo--E-B---oT-X---X?--oo-oX-TT-X----?-?-----?o--B---T----------T---o?---oB-XBXX--M-XTM--M----T-M----oBT---?M---o---T-o----M--X-TT------XE--o----f
------??|----X-|-Eo-|E-----E---E---|---X-||--|-E-------M--|--B----T|X-B-T---E----T|||-?X-----o-------------|--T--X--T-TME---XB------E-------|--B-----To--To--|T-o-E--?E-XX|---Eo---TE-|M----?---------Mf
m-------|ET-o--|----|----E--X-o----|o-Eo-||M-|-------?----|----TX-||----|E--X----|-|----------X--T-E-----E||--|-X--o|-----X-----|-TB-E-?XT--|-|-X-o--||-T|----|------BB---|--E-X-E-|B---E---X--------|-X
XX--X-XXXX-XXXX---X-XX-XXXXXXXXXXXXX-XXXX-XXXXXX-XX-XXXXXXXXXXX--XXXXXXXX-XX-XX-XXXXXX-X---XXX-XXX-XXXXXXXX--XXXX-XX-XXXXXX-XXXX-XXX--X-XXXX-XXXXXXXXXXXXXXXXXXXXXXXXXXXXXXXXXXXXXXX-XXXXX--XXXXXXXX---X
