-To--T--M---?o--E------X-EE---TB?-X-o--??----E?-o---X-BM--E-B----X--X-MX--------o----oM---T|X---M----M--E-E-B--|--------?B?T-oXE----|-----T-B?-o-MXoo--EE-E-E??--o||-ETo-|MM--E-----E---TX--T-o------T|-
--X-----B---|M-o---E--T--oo--o---?--M-B-X--B------|-T-----o----------XB?BE-X-o--?T-o-?-------|---T---TE---------------M--E----MX---------o-----BB----Eo--E-E---B-|--T--B--M---?E------E------?---M-|--X-
----E--T-X-M---BB----?------B?|-?-ETX-o----MT----|-X|E-o---E---------T--E--?-E------o---X--X----?-----MXM-E----X--------?----B--T-----X-?T-TXE--TB-X-?-|-BM--TX-E--E---o|--o-B--------||M|T--E--T-E-|-X-
---B--T---?--B----TB-?--M----MM-|B---------o-B------------oX--E-oE-------TT-----E----M--?-o----B---|BB-o-T|--M----|---|-B-M-o----M--------------MXXT-B-X-------T-B--M-B--MXBM--oB-----M----MX-M-----X---
--M-?E---o----?E-?---B---|-|M|--EM--TX---?--|-T---?----E-?---M-TM----o--E---oo?-|-XE?-B--|-----?-T?B------|o-|---E--||-----T-T-B-------E---TE-T--|-TM--EEXT---ME-XT---B---T|-----|-X?-o?-----T-To-------
---M----BX---|--BM------o--|T--------------EM--M-|-B-M--M--B-----MTXB----||-----TE---MTXX-MToo-X--?-?|B--X-----X|T--o--M--?--MM|-|--M--MB-?o-T-EE---o-Mo------M-------------X--------B------|---X-o-o-?-
-MXMo---M----EXXT--|?--E?MX-XX--B--BM-?-T--?---|-o-BB-T---?B-E-T-------o----MEM--T-------Xo--oo-T---?--------MXM--------X---o-----------X|-|---TT---BT--X--|X---|-------X-M-T-T--B----?----E|----E?M-XM-
-?-------X-|-B--X----XEE--|TE?E-------T---?-X|-------XM----------o-B---X-?oE---------X-|M-E--E-------MEMBE?----T-X|M?M--o---B??-----X?XTX-----M|-----B--M--?-------B-XT-?M??E----?-B-T---X----E--B-----v
-|-------X-?--E--?---MBoM--|--E-?--E-----T|------ET?T--T----T-MX|B---|-Mo----E--BE-EE--B-B-|---M--B--X?-?|-MX--?----------B|--B-M-B--------E----E----B-M-?---|XB----X-?---??X--|-B-----------|?---B?--of
--M-|M-|--B?--E-X?-----T--BEX-----B---ToM--?-o-----T----o--||M?--B--|--EMTo-E-X--ET-?-T------M-Xo---|--|--o----|EB?------|-------|?-B--EM-|---------M-M-----T-----BMo--T-?|-|---T-B---T---B----|-----T-f
---o----M--Eoo--ME--?X-------E-oE---?-----EX---M-?----M--?----------B-B-B--T---|--ooM-MXE--E-MB-TX--?--E--MM-TTMM-oMo--|--------|---|---------o--------oT--------MTEM----------M-T-X?-----E|?---TX?T-o-f
-----B--|------?-MoET----|-XT-?X--o-----|-----ET---|---M---?-----E-------o-ET-X-?-------?M-?-X-B----T---X----o---------oM--?|----EE?-E-o--T------B----|ME-|o|-M--MM-|X?|-E-----B------M--------M---X-B?f
-X?-----X--|oX-T------B--|------o-TX--o-------|?--?------B--X|------EBX-|-o---B||E-B---M---B-XMTB-EM|--o----T-----|----E---T-||B--E|X----?-M|---E-X--B-|----|M-------XoXM-?-X-M--E---B|||oT--T---------f
--T----------o--B--|--------|--T--M-----?|-M---?-E--X---EM--T|---E?B-E|----E-T|T-?E-----MT-o---?-------?--?---Mo--?--?--X-B----|-E|ETMT----?|-E|?|E---T?---TTT--MXB----|--------M---?|-?B-X?----?-o-M--f
mT----|-|--M---B----E-T-|-E---X--o------E-X------BBX---|-|--TTo-M-------MMM--|-E-?oB-----|TM-|E--B--|T--T---T---|-o--MX-E|?---T---B--o|----X-----EX-T---E--E--|o---B----o-------------??-M||-?-MB-MEo-TX
XXXXXXXXXXXXXXXXXXXXXXXXXXXXXXXXXXXXXXXXXXXXXXXXXXXXXXXXXXXXXXXXXXXXXXXXXXXXXXXXXXXXXXXXXXXXXXXXXXXXXXXXXXXXXXXXXXXXXXXXXXXXXXXXXXXXXXXXXXXXXXXXXXXXXXXXXXXXXXXXXXXXXXXXXXXXXXXXXXXXXXXXXXXXXXXXXXXXXXXX
