---M------T-E--X-------T|--------M--------T-------B---X---------------------------?---------TX--TE-o----BE---X-----|----X-----B--T--o--------T--T-------TE---T-----B--------E-B---------------?T--------
---T-----T---B----------X--o-----?-|T----?-?B--T|----T--T--X---------------E--X?--------X-------X-E--X----o---?---T--?---X--o---T-?--B----XT--T--B-X-oX---TX-?------B------?--X------TT---T-To--------T-
------B---BTT-----------T-oo-MB|-----------?---Xo------T--?----------------M-----------------T------|-Mo--?-X----B----B----?-XB-----|--T------------o---------o---|---------|-------o--------?----------
--E------T---X-B---------T---o--T-----|B-oBT---E--------E|----------ME-X----------?----|---?-o------?------|T-----------T---o?--E?TT------TT|X-------B-----------o--M-|T-------o----M-----E---X-----|T--
-o---------Xo-----------EM---------TB--X------TB?---T--X-B--M-B?-------T----------------B----o-o---o--TX------------------T-----------------------T--T------X-?--------------------M--E-BM-B---T------o-
-T-o---------o----------?--T--?---------E----o--------M----oX--T---?-------T--T--XE----X----M--o---o-----EB---B--------T---T----------TT-M--------|-------T-------------T-T?------------X----------ME---
-?-TT---E-----T-----?--T-E-------E-----X-oo--------T-----X----o--------X----------B-o---?X--------------|---E---T------------X--?---------------M------|------------|--M----?o---------------MX---------
-----------------o-----T------?------X--ME-----o----T-B-----?--T-E--------X--T-------o----X--------------------X-XE-B-E-----?------o---X------T-------M-----?-------E-----------X----------------------v
---------------|-?---o---------T-X---M---E----B--?---B-T-oT-----T-B?TM--T---B-----X--T----------B--T-----o---------B-?-------------------------M?------------o------T--------------------X---------T---f
-B-?--T--M------X----T-B-X----o--TT------T-|-T----------------X--XM---?MoM----T-?------?---B---B--------------MMT----TT-----T------?-T-T---------T------------T--------------BX-------X-T-TM-----------f
--T?--------E--?B-o-----o-----T-------------EBBB---B-------------------------T-----T-oT----EM--------o---T--o---T--------------X--o-o--B----------------T-o-----------------T------------------o------|f
---|T---------T--X-------?---XT-----TM-----X-X-BT--T-----T--o-oB--o--T--XX?-Bo---------X-X--o-T---o--E------------T--T?--------?-o-o----------?----T----------?T---T-T-X----T-------T|---------oB--X-B-f
---B-TT----E---Xo------Mo-X-----oo|-oT--TT-?-|-X--TM---X-----|-----To----E--T|--X---|E-TooTE-E?--o--B--o---------------oT--EB---T--T--T-E----o--MoX--T-T------oTTM--o----XX---oB--To----------T--T-M---f
---M--B|--oBT?----M----M-Eo-X-X------B--o----BX-MX-M-----E-T--T-XoBT----XB--X---o---T-|T-E--To-EX-BT-o-oToTo--o-?-M-XE--MB-TETX--X--?TM|---T-TX-TB|X----E-B-T--o--TMX---T-BX---?T--B--MTEX----TB-oT?T--f
m-T?-E--XT-oMT---TT-TM-o-----?----T-X-o---E-oX--o-o-MXXTBXM-X-TX-B|-T--T------|-oT--Xo--------B-B-T-o-T-----TTTT--X----oo------TTX---T--MX---?-T---?--o--------o--B-T-oT-X-X--|-B--B----?---X-X-B---X--X
XXXX-XXXXXXXXX-XX-XXXXXXX-X-XXX-XXX-X-XXX--XX-X--X-XXXXX-XXXX-XXXX-X-X--X-XXXXXXXXXXXXXX-XXXXXX-XXXX--XXXXXX-XX-XXXXXX-XXXXXXXXXXX-XXXXXXX-XXXXXXXX-XXXXXX-XXXXXX-X-XXXXXXXX--X-X-XXX-XXXXXXXXX-X--XXXXX
