-T--XBXTX--o-X-T-TMXT--B-B|ToXT-XBTo----TBETT-XMMT-o?-?B|TT-??TT-XB-EB|XT-XXE-o-M-o-X?oT-T|o-|XEE----?-B----XT?X-o?X-TTo?-X-E----oX-B-MTX-X---MX--|o|ME-XT-oTTo-TTTo--B-XMM-?--X??T--XXE?-Xo--Eo-M?-T---
--|TXEoE-T--oXXMT?TooT-XTX-EMXoTT-T---X?T?B-Mo|-X-T|-ToMoT-oT?o---T-oEXT-oT-----oX-?X-MXB??X-?EoTM?TXoTT--T-?Mo-BTo-M?-X-EE-MT-T-o-M-o--?-|MTB-E|--|B---XXT---BBT-ToTTTTB?-XB--EoTMTTMT-B-XBT---T----T--
-T-TB?--o-oBXT|-X?TBo-TMBBMXoBoBTBE--Xo---E--XMX|TTTMo-?--?XoXX|T--T-BETMX|E|-T--E-T?-oXT-?T-X?o--oMBX?--o?oMEo-TM---o-EMT--TX-oE|oB-E-B-TX-T-TM|-?-XT--T?MBT-M-T?X-T-oTXEEoT----ooB-o---X??oToB-XTTX|--
--T|BBTXM--TTX|-ooXBo--XME|?TTTooEXooXoTTT-?BT--MoEoTX|-??X?-XE?B?TT-BT-XT-BB?E--|--Eo---XMTXX-----XM-EX-X-?M-|TXT--X|T-M--E-Xoo-XE-ET-T-oTToTTBE---TB-Mo--oBBoXTToM-B---?T|-oBoBXo?T-oTTo-MTMXTo--T-oX-
--o?E-XEo|-?B-X-ooTX--BToMM|X|--X--TBMMMTX--Xo----T-E?oX-oBTooT-o?-|EToBTTo|-XTX-|E-?o-X-B-X-o?ToToX-XooM-?-Eo-T---X-oXXTEo-X-T-BX-T|MB?TMXTE-BT--ooMoo-T-MTE-ooT-B-T-|XX-To-T-|--To-E--?E|?B--XB?|T--o-
-T|XB--MXT?TB---o-BMoooXMT|-oXXoMoT-XE-oB---T|?oX-X|T?E-o?-BET??TBM|ToTooXXB-EToMM-T-T-M?-BME?-?-BX---o--oT--oo-TTXX-TTTTo-X-o-TooTM-?MT?-BE-XT?-?--BTTEXTTXoTTo-B---TEM-EB-X-BX-|M---?--XT|BToE-ooTXTX-
-MBB--B-BTT-?BXo---BoX-BX-oEToo-?T-Xo-E---X-|oM?o-To--M?B-------|XTo?Bo-|MoT?BXE--X-oB-o?-ET-?E--E?--X--ET?-XX-EBT-BT-M-oMTB----o|-X--TTMT-B-----BToT--XT-TMX-T-X-B-M?o-oB-E-XoX-TT-E-ETT?-EBT--BBT?--T-
-oTB?-BXETEME-EX-B?--X-M-Xoo-TTXT--MB-MT?oo?TX|X-XT-|?To-|oX-BT-TToTTX-TE-T--T|-XX-oX?Too--EoXBMoMoo------?X-TE-oXoEX---?MBoToB?T|o|X--TBXBMB--TX-T--?BETT-T--o-M--T-ToT??M-o|B-o--oX|X---o-XT-M?X-o-?Xv
-?To-|oM-X-XX-?TEBXXTT?|?|--?-o-BXBX?XBMB-T-?-T?-M--To|MoTE?XB-o-XX?Mo-ToX-XT-ET-M--?|B---BTo-?XoTo---M-MXoX-oT|-----|T-T-o?o----XBM|-----BTBT--EoT--MTE-oE?T-T-EX?oo?T-oTETTEBT-?-B-X|-o?TTMXT?T-oo?|of
--T-MoT|T-||-E-oB|o--M--|XTM-oTTT-TTX---T-Eo|MX?-E-M-XM?X?X-?-TX-oXTB--E-TTB?X-T--MB--XMXTo?X----TTB----?|TB-T-B?E-XTBM--?X--BEB?o-?o-E---XX-XTTMEo---?--X-TBXMX-ToToo-EBET-T?--BB-??BX?-X-T-ToBM-?-B|Xf
-XoM--|BM?-oX|--X---XEX?MMT|o-E--EoM-o-?XBoT?BMMXT--T--T-o-X-B--X-TToTBXT-|TooX-oB---TXX?--o----?-T?-XET-oo-o----|-T?-BTTTM--T-o-B-T-B--TMEBT--T-XTBXTTTT-XTo-XBMX-X--TEo-TXToTT-??---o-B-?X--XT---|o--f
-o--|o-oBTET?EXE--XBB?X-TXo-o-XTT?-X-|XETX-o--?EXM-?-MX-Xo-TM-Too---XX--oMo?-?--?-TEMTXT?TXo-MT??--BMEoXTo?oM---EXX-?-oTX-oTE-TTMT--oX-|X?-TXTE-XTX-TE-X?XT?-BT--BET|T-?o--o---?-TTTBo--TEoM-T|-T-?oEo-f
---o-B?-ooT--B?-E?-X-E?E-B?-??---???--o-?---BB|E-XXBX|-?E--M-XBoXB-T?oEM--X-XoB---?M---o-B---XBT?-o-BXXEB-BB--X-?B--EXT--?XETX--?XBXX-XB--B-M?X---M?o?-Bo|ME?BBE?B-o??E-M--EXo?o-E?XX-?X-oM??E?XX?-?BBof
----M?XX-o-o-o?--BBE?XX---X-BBoXM--XB-E-BBBTX?MB-XXoEB-?--X--BXBMB----?-?o-BB?-M-BB-?-X-BM?-BoBMB-?B-?B--BXEX-o-BEX-MMB--MBE-XBXMMXB----BoXoT?X-B-BBX??MBX-BX|T??-MBBBE?T--???-XX|BX-XBB-B--oX-XETM-EX-f
m-BMX---?-oEoB?X-B?BMMX-?X--Bo-XEoX-XM-B-B-B-oB-M-X--TB-XX--?X-BB-?EoMooo-BXE-oBX-ETB----B-B?oX?B-B-M-o-X-XBB?-X|B-XX?BXXX-oX?MBo-MM---o?XMXM-MMX|oBB?-o??BX?X-XB--oBo-?oo-oMMXB---oB-?MX---XE--?|--BBBX
X-XXXXXXX--XXXXXXXXXXXXXXXXXXXX-XXXXXXXXXXX-XXX-XXXXXXXXXXXX-XX-XXXX-X-XXXXXX-XXX-X-XXX-X--XX-X--XX-XXX-XXXXXXXXXXX--XXXX-X--XXX-XXXXXXXXXXXXXXX-X-XXXXXXXXXXXXXXXXXXXX-X-X-XXXXXXXXXXXXX-XXXXXX-XXXXXXX
