---------------?----------------o----------------------------?----o-----------------------?--------E----------M--------M-B---M-----?--------M------------------E---------------o---B?-----o-------------
-B------------o--------------X-------------o--?o-------------------?----------BM-----------------o--------o----B-o-----o--X?------X----------B--X----X----------M---------M---------o----------E-----X--
---------------------------------o-------------o-------------------o------X-EB----------X-E--X-M----o-X------?------X?-E---------B-----E------E------M----M---X--------------X-?----------X----X---X----
-X--X?X---------------------o--------------E--------------------------o------X----X-----o----X-?--------o------X--------------B------X------------------------B-----o--Mo----------M---?--------o-----B-
-o--------------------X-----M--X----X---------------------X-------B----------M------o--------?-----------------------B-----------?-----EXX----M--o----------E-----------M---------X-----o----B----------
-------------------X------?---------------Bo--?---------------X--o----B--------o----------o----------------X-----?X-M--B---------B----------------------E------o-----------BB-------------------------B-
-------XE-----------------X----------X-X------------------------------M---o----------o--X--------X----------------E-----M-------------------------?---?-----?-------E-------X---------------------------
-X--B--X-----------o----------o------?-X----------o-----------------------------------------o----E-------o------o----oo-E----------o--------M---------------------o-----M-?o---------X-?-X-------------v
--------------M-----------------M------------B--------o---------------E-------o--X-----XB------?-----M-ME-----------------o--------------M----------oXB------M--M--------XB?----------------E----------f
-----------------B--B-------?------------------E--ooE----------X-M----o----------o-----------B------------?---?------X-?B-----------?E----------------?-----B-----E----------B---------o--B----B--o----f
---------X------------X---M----B-----X--B---oX---------------M--X------X-----oE--------o---------------X------B---X-------M-----X--X-------M---------------------X---o---M-----X-------------------?---f
-----o--E-----------o---------?-Xo-----------M------o----------------X-----------X----------------------------o----------o-E---------X-----?-B-----------E----------------------X----------o--M--------f
------?-X-E---------B---------XX--o--BEBX--------o--M---------E------M----------?-----------E------XM-M---X--E------X--o----o-?----X---------o-?---M-----M---------------X---?-B--o--X---B-o----X-o----f
----------B-E-------------------?-o---X----------X-o------o----?X--X-------------T------------E-M---?---------------------B----o---o-----o--o------------T----TX--T------o-B---Bo--------o-T--X-B--M--Tf
m--------------B---E-------X-----ET-E----o-X-----M--E---X-----E-E-o--??------EX--|X----o---X-------------E------X---?M--------T-E--X---?TX--MX-----E--E-?--o--TE--|---------T-----------M-M|X--T-o----|X
XX-XXXXXX-X-X-XXXX-XX-XX--XXXXXXXXX-XXXXXX-XXX-X-XXXX-X-X-XX-XXXXXXX-XXX--X-XXXXXXX-XX-XXXXXXXXXXX-XX-XXXXXXXXXXXXXXXXXXXXX-XXXXXXXXXX-XXX-XXXXXXX-XXXXXXXXXX-XXXXX-X-XXXXXXXX-XX-XXXX-XX-XXXXXXXXXX-XXX
