----o-----X-o?----EXBT------------|----M---o---TB-M----E---|M--o-----?--B-X---E-E----M---M-M--E---BBM-|---o?---B?X--|?---ET-EX----M-o----?---B--o------B--------oB---T---oM--EE----B-E----T---|-----BX--
--??-E--------------EM-EE-B-B-E---T---M?-M----X-TT-|-----------o-?X----------------MM|MX--X-T-|-?---B-TXE---M-M-X--E-------M-Eo?|BT-T-T-T--o-------oo------|------MXTXB--B--?--|-?---TM----|-------?----
----|ooE-|-T---?-|--B|M---EX----?XoT-|-?-XXo-T-----TMEB---|------B---T--MT-M-------B?M---M---X-X----MX----E--E---o----TT---X----E-M------M-o----X-X---T-|--X--o-M------------?-----X-BE--|--?--|--M-E-T-
--?--|---EE-----B-TM------BM------Eo---T-----M--------X--MME-|-o-T-----oE|-o-----------T--B-B-XE-M--?--E--------T|-M----E--|--oE-o--E||-E----M-T--T-o-Mo-M---?-B--|---B----M-|MMM--XEo---o-oE-oX--|-|--?
----o?--T-?TE--B---E-|--MTo----?-M|-o|-?---|-Mo--BT------X---M-M-o-BTB-----o----oM-------|o----B------T---XXM-E-o------|--B--B?-?--E---|-T------TEB-To----o|-|M??-M--BBo---EX--TB--?---X-MB--B---X?|---T
-oEM-------T--B---T-----MT---B----B---ME-----E-----T-E--T---|-?--E---|BB---o------BX-|o-|---o---E-B----X--X-T-X?E-?----E--T-MoM-o-T-----M----MT-TBT-E?M----MX------------|--?----X---M------M-E?BB-?----
---E-E---E----E------------o-oo-----|?---M-----|T---X-T--|--o?------?--X----MT?---oo--ME-M-T-|X-----M-?----B---------?--T-X---oXB-----E---MTB|M|----|-------TX---XT-T---|--|--MM|-------M-----||o?--|---
-T---TM--o--E?T--B--|--|TT---X-o----EoE-X--T---B-X-|--E--o----?o-E-----o-|o-|-----o|X---o----E--B--E----XTM----B-X-X--?---?---B---B-E---|??E---X--T-?-----E-M-BoXX-M--|-|---XB-T--o-B--??----|T-?E------
----|?---------o-T--|--X|o-E----T--EX-BX|-----|?--|X-------o----o?-----o------E--|X----BM-----|?-|oXMM-----T--|-X---o?------M---E-B?-|--ME-----M------X--BEB---o----M?----X--XE----E?--T----?M--|-oo----
---M--o-E----XX--o-----?---BX-E--oXE------oT-------o?XB||-E----------oBM-?-----Mo-M-----M---M--XM|------X-T-o----?---oB--|-||-----------?-EBX-----?-----X--ET|-o-o-T--o-B|-|-----X------B-----EM|E|T----
------EX-|E--X-X-----ET----o--o---|---BE-X-|---X-----T--|--T--?-B--|--B----------E------|---Mo----BX----M--||--EMMM-T-?-T-|-TT-o--o----TE--|M----B---TT----EET-X--XX|-B?--Mo?o------BE-T-oM----?|-------
-T-o-?-B-T---ToBM---MBX|--BM-TX------B-EBB---T|---?--M-|-EB-o--XBB|---TB-----T-M|o-----T-EX--M-M-M-E-M--oE-T--B-B---T|||---ET------T-B--E-----EM-o----X---E--|?ET|-X-E|T?|?---------------X-X|--B---o-|M
-B-XM--MTX--X-XB-----TB----?---------M--oo--|--||-E---?-?--M-----?-----o-T--|-E-o-----o?-BX|?--||--XX--T-B------E-T-----E--T---TMX---MM-B------?--T|--|-|?M-?-----T--T-T---MT-E----|----E?-----|--E-----
------M-X---B----X------?-|oXE-MM----MB-|-X|-E--MX||-B?--T----o--E---?-?------T--X-----?-T--o---B-o---?----MMX?---XBXoE--X-o---o--XoE-|-X--|---B---?-T|-M-------?----Eo----XE--|-M-X-T?M---?o-o---|E---X
--M--|----T------T---T--E?---B--T-MT-----ET----?M-X-o-?-M---o-?-----B--E----E---T?XBB-----M---?|-M--E---BB-?-ToX-B|--?oo---?---T--XT--------B------B---X---o----oEM--?--E----o-------E-X--X?---?-?-----|
-XXXXXXXXXXXXXXXXXXXXXXXXXXXXXXXXXXXXXXXXXXXXXXXXXXXXXXXXXXXXXXXXXXXXXXXXXXXXXXXXXXXXXXXXXXXXXXXXXXXXXXXXXXXXXXXXXXXXXXXXXXXXXXXXXXXXXXXXXXXXXXXXXXXXXXXXXXXXXXXXXXXXXXXXXXXXXXXXXXXXXXXXXXXXXXXXXXXXXX-
