---?--?--?BoT--oM|ToT-B-X-B--?BT-o--?EoT-oo|T?|-M-XT---oTEoToBooBMT-BMXXoX---?|BoMEB-TMMTET-----MMXE?X-oXooT---?oEE?-Xo-XoT-ToTTBX--ToE-MTMoBTT-E-ooXM-o-XX-----T?TX--o-oTTX-T?TT-M-X---XBBT--M-TT-oXTM-
--Xo?-?T-?T-?-E----?-?MT-oT-?X-----EXXT-X--X--XTT-TT||?-E-X-T??-T-?---MoX-B--BXTXoTEXBo--o---B?To-ET--T||XXTTBoB?-TEo-E-T-XXXM-TE?XT--TE--oXEo-M-XE--X-XM|o?TB-Bo?-?-ooX-T-B|oX-?-?-X-|TT-BT-oBo--BTET--
-T?-MEo?TB--M|oXTB|T-EX-oo-MTBM-?E--|E-X-XX--To-XTTE---X--TTM?o?--?o----X|-o---ToET-----TTE?T-Too-ETMX?To-?XMoo-?-Bo-E?-X-TTXo?---X--E-?-X-BE---MEoB----?-TTB?-M--oEBMBT-XM--o|BXTT-BT-To-TTTXEXX|EXX-T-
--?--TTXE-o?E--TTX-oTTMBBBoTBX-T-ETT?T?E-MooX-oM-EM-oMoM?oo--X-XTTX?--XXXooT----?-E--TMM-T?X--o-EMXXE-MM-||BX-?--E-MXMX---TX-X-oBTE-o----TT--T-ME-TT-T--?TT-o-?o?--XTEE-oo-B-XME-X?TMoo-?oTXToT|------B-
-M-o-E-T|-T--ooB--B|-MX--|BT-o-XTET--MMo-XBTB-TBBMT-T-TET-ToB--X-E-?T-o-T-To-M-T?--T?TMo?-TT-?-T-X--?BXTT---MXT----|?-?-X-M-|-MTT-E-o---XooTMX-MM-|?M-?-|B?MXToT-T-TTM-E--E-?|T?X-TEE?-M|?--T-XTB??--XE-
-T-ToE-|?XoTTT-XTTTMME-MX-BT----?T-E-|TM--TT--oME--XEM--?o-E|T---T?|-?ooEBBB--BEoMTT-?-TM-BTT--EM?---|B-BTB|B-EMo-M--Eo-MTET-o-o-X?----XEM?TBTM-o|-?TT?M|-?X---ooEXBX--?o|BTXoTT?TX?TMTTT---?-?B--MTM?M-
-oo|MMXXEo--MX?-X-M--?T-o---|--BBT-X----EX?E-Bo-MXooM?--XToTT?X-T-oMXT----TTT?BToT|TT?-E--?X-EBB?XX-T-o--?E-Xo-ooTToX-|o?ToTTB--XT-T-TT??E-oXMM--o---o---EE-BX-T--ToT-E-XToME--XX-|XT---B--oXT-T?M-MM-T-
-TTT--M-T-o?-TBoT--TXTo----T-X-E-----o-X?X-T-E?|T?B?oMoXBBT-TT-BBT---|X----BToT-E---B--TMME-B-----o|?oE-E-XTTT-|-o--TETE-E--TTX-X-Bo--ETMT-BT?oX-Xo-TT-X-M--B|oM-T|o-BEBB-E?B-TTo-T-To-oX-?M-oo---XToEEv
-XT--TM-M---T-TE-?-T-B|XT-o|oTX-TTTB-MB-oB--oET-Bo-o-BETTT--T??-B-oX-|-BoX-T-X--o?XB-M-To---XTTTT-XT-EBTXT-oT-TX-Mo-T-M-BTEB-B----EX--?----XM----?T--XT-E?oTXX-oT?o---TB-T-B?XoMo-B-o-X-TBoB-MBMTTEoTTEf
-BXEX-MTo---TTT-TT|T-MEX-B|----oTE|Xo---T?TB-ToTTX-TXB----TTToX-T-o--TTBT?---B----T-oET|?T-Mo----Too-|X-E-XBoo-Eo?ETXoB-TE-XT-MXX-X-T|ooMoMoT-T-?o---TX-?--TTEXEoB-XTXo----?-|----B-MB--X-B-??-T-T---T-f
-BX-E-?oXo--E-oBEo-TT-B?o--oB--o--oM--B-oTToXB--oTo-oEXE-MT--EoTXo-oTo--T?-T-o?MXXTX?XT-EETT-o?-|-?E?TE|Eo--TBoTXB-MX|ToBo-T-?o-?|-X---B-B-Eo-TB--o---TT-oT-MXMEX-?--TBT?---EMTX?-T----TTo-----oB?oB-oXf
----o---o?M-X-ToXX?BTTo-TToX---T-o|-?-o|ToT-T-E?T-M-T?T-?----To-oMX-o-T-X---E--T-Eo-M-|--?-B--M-EEMBTo|TM-MBXTT|M--?T-Bo-o-XXXE-?T-T-EMo--B-XXXMToXE?BB|?EMB-TTo-T?o---E---X-XT-?E-M-X-|XMX?-XBo?o--?T?f
--o--BBB--B-X|?B?o----?B---BX-?XB-?-|B?-?-o?BB--XXXoo-XooBXM-XE-MET-o-X-BB--BoX?-?--BXo-oXoE-?-B?oXo-Xo-X-BBMXBoMX-X|B--BXMB?--EBX?EXo?EMXB--XoXo-?--EBBE?-XB--?XE?X-X-B?X--M---T---BX--|??---B-?BM?BEEf
-MoEEETEE---EBM?BE-oM?oooMMo-?o--oBBB-oBM--XB-XX---B--M?XM----o-|?BMMBE-Xo?-?o-B?-TB-??|-XTE-MXXXo-Eo|XBXo-BoX|o----X-?---BXoEXoMB-?|-?-B--MEXoX--EBoX?X?X-B-XB-EMBoX-?-M-o?-?---X-MB-oo-?BE-|B-X--X-?|f
m-E-B-BB-TX--B-ME--X??EXX--X--BX?E??-|M-B-EB--oXX-BM?X?-?BoEM-XE-o?-B-X?-XXo-o-oX--MEXXXXo-E-BM?MXoB-BXXoBo-BX??-B-oX-MXBE-EXo?-EX-B-XoMEM?X-XXoMXB-BBX-BM--B-o-oBM-EoX-M?----Bo---M?M--oEXX?oX-?M--|XoX
X-XXXX-XXXX--X-X-XX-XXX-XXX-X--X---X-XX-XXXXXXXXXX-X--XXXXXXX-XX-XX-XXX-XXXXXX-XXXXXXXXX-XXXXXXXX--XXX-XXXXXXXXXXXX--XXXXXXX-XXXXXX-XXXXXX--XXX-XX-XXX-XXXX-XXXXX--X-XXXXXXX-X--X-XX-XXXXXX-XXX-XX-XXX-X
