--X-o--MoX-XM-?M-BX-XT-X-XXTXMB?T-TT-BE---|-MXXo-T-XM--XEX?-X-T|-ToT-Bo-M-X-TT?oTTX-E??TT?-o-?-??BM-T-MTTXoET-TMX-T?T-Xo-TXBoTXETTXBTT-X-BTX-X---T-o---oXTBT---?X--o|XB|------E-oTT?X-o-TT-T-T-ToB-?-oX-
--E-|X-o|?TTX-T-XE-T|XT-o?-T--B-T----|---|-T-oT--T----E-oB-XM-X|-TBTET---X-XTMT--MEoEXX-T-BX--XT--To-M----o-XoEEXM-o?T|X?oTT---Xo-T---XM-E?XXBT--Bo---BoX|To-M----TBTXo--BX?-T-?MEo|oM?T-TX-T-ooBXBT-TM-
-T-?XT--TTE--XEXB?oME---?TTT--BX-o--TXXX-XEM-BX-E--oTX-X|MT-o|-?---TToo-oM-?TT-BEB-TXTMTB-ooTT-E-EoEMB-B|X-XTEoM-TB?T-o--B-oT-XMBXEX-To-TX-Bo-E-TXE---T--TMTE-X?-o-?MTXXMT-|-TX----o-?B-?-oo-X-T---TM?T-
-T-oTB-EB-BoETTXTXT--o-ooTMMTETTT-ToTT-?--?|TB-o--TXTo-E?o--BTX--oB--T-X|TE-B-B-BXoTT--XT-XMTT-EoXTEX--X-oTXXMXoTX---X-TT-XMXM?o--To-MT-?M-oB-X|T|-TM-EXT?-?-o-XT?-?-TT-o-T-?|--XEo-?XBX-oX|BEo--T-XXoo-
-TT-TXEM|T-X?T--EToo--T-oT--oX-E-To-oTBo----?M--X---T|B|--TMooET|EM---BTXMX--o-oT-X|TM--T-TXX-T-|TooM|---TEX-?B?BTTT?MM--MTT-T-X?oT-XTETTETX--TETMo-oMTETB---To-MBM--To?B-ETXBME--TB-TB-Bo--TMXT?-TTTMB-
-??Eo-B-ToooMTBToBoE-M|---o??B|T-TX--TX--TX-T-B-XTX-M-T-T-ToTXT-TooE-XTTME--?----o-TTToB----B--TXX-X?T-Eo-oT-X-?-oX?-X-oT?oo-X-XBM--ETB||-Eoo|MB?-TMToX-MT-E-Boo?-TBM-oToT-T---Mo-o?XE--T?TX|-|-X---TX--
-TBBTX-?EBo-oToooX--TX--BXTMX-o--XX--X-oTT?|XBoXEX---oM?-MM?-TXET--oMX?--TX-?E-Eo?--oT--oET-BME?--BEoo-oTTToMXoo--?oTXo?E--TE---|-BTEB-TBEE--BX---XMB-TX-Xo-oTXXEE-Bo--BT|T--o|BMoX-o?-XX-?|M---T|Mo----
-TXoTX--?oBT--X?X-MM--B-BT--BTM?X-TBo-TToooo-B-?----|oB--B?T|E--o-T-X--o-|-oX?T-oo-XBM-XE?T-TE--oTooo-ETXXX-oT---M-XX-oT-MTT|??ToXTM-BBTM-|T---X-T---B-EX-TT--X|--oTMXX-TToXEBo|-M-oET---?--T-XTTo-XTE-v
-Bo-oXo--?M-?oB---XBEET---TB--BX-B-TB?-TB-|X-M-o-TT?-BoTET-M-?o-EXMMXXT-EMTXT?|oX|X-MMT-BBooToooE-o-T-T-XM--BEo?-EM-X-?--TETX-TB--E-B?--Xo-T?--E----TX-o?-TXE?--o---oT--XEET-oEooT---TXT|-----T|-TE?TT-f
-|?X-TBo-MBB---M-T-E|------BX-X--ToBo-TX--T?M-E--|BXXEB-o-T--Eo--M---?T??BT|EMX---oT-T-E-BE?-oTTBoX-o-BTEo--B--X?--|-?-|--|-o||-|-T-X-?B-EXo-To--oXB-T||ToMBoT-?TETBB?TXXTTX---Mo-XXXE-TT-?---XoBT--M-|f
-?TX|BT?o--T--E-X-T?-o-B--M?oo--X?----B-T|-oTTB|-|TXBM|TBX---E|-|o-T-E|BTXEo-?o?o-?oXT-TT?TT--TTTo-X?-TXEMBX-METo-----oTE-oXTE-X-TToT-TTBT-|TTBX---o?oEEXM--o-T--T-T----XT-T-Eo-?-XTo-B-oXXBB--EXE-M-B-f
-M-MoTBoBo-MT|T-E-X-M??E-o|XEXo|oT?XX--TBXX-T?TTX-M|TX-o---B-X-B--E--TT-oT-?MX|-?TTo-X?XET-T---?-?-T-BTBXoTXEBoT?TBBBToTX-TTB|-o-X-ETEoX---TT--?MEM-Xo?--TT|-MoM-TTXTT--TM--?---ToTTTEX-oB|BTo-T-?T-ET-f
-?oE-B---?MBMXM-E-BoBoBo-TX--T--E-B-o--B--M--o|---TEBE--Bo-X-?B?TXB--BM?-EXo?E--o-XMXX-oBE-?-BX--M?--oBBB--MX-XM---X------X-XBX-BBX-M?--B?BXMo?BE|M?M?B-BEMMXT-XX?MB-XEXXBX|XoM-XBB-X-M--XBX--BoB?BM--?f
--?-?-o??-?-XB--?--?-TMX----B-?XBEo-XB?XT?--X?---EM--ooo-?--E?BE-XBBoB?o-BMX--BXooXXo-BXX|oXB----o---?o?BX?o----BX--oMXBX-oMo-E-?-o-B?-B?-oo-ME?-B--BB--XoTB--M|-oEB-B-X?BT-X?--X?XXXX-MXB-MoM-E-E-XB-Xf
m-?XBoB?-oMBBX?-E?-X---B|?X-X---oBE-E-X?-XBoB-MX--o-E-B-BX---Xo--B|B-o?X-?o?ooB-MoE--?MooE?TXBoBBB|M|X-BBB-?-?-?BB-BBBXXM?-BTX?--|M?TM?-?E?-?o?MBo--X-?M-XEoE-BEE-Xoo---X-?X-?MMB-BX--Eo-B--X|-XToXB-oMX
X-XXXXXXXX-X-XXXXXXXXXXXXXX-XXXXXXXXX--XXXXX-XXXXX-XX-XX---XXXXXXXXXXXXXXX--XXXXXXXX-X---X--XXXXX-X-XXXXXXXX-X-XXXX-XXXX-XXX-XXXXXXX-XXXX-X--XX--X-XXXXXX-XXXX-XXXXXX-X-X-XXX---XX-X--XXXXXXX-XXXXXXXX-X
