-o-TXTT-?ooX-?-o?X-T-TEoTooTTMooXMo|-XT?o-TETTX-M---?-o--?oM---M--TXBBoTT||--??TM--EX-XBT-o?-?TT--Bo?T-X-B-E--X-TT---M-XBTET-TEBBX--X-XXX--o?oB-X?---T---X|XTEToT-XoMXEEM-MX||TE-|B-TBT-TMMEBTX-TXTo?---
-XXo---?-||E-E-To-X-X?BE--o--?Bo---T?B-XT---TT-M-?BooE?-TTTM--?T?-TE-B-?-B---||TBX--B-?-?E-o-X?--ToBEXTToX--To-T-?|-MXo-?XT-oXE--o----B--M?oBT-Eo-TX-----XTTBET--T?MMEXX--BE-T--M--ET-M-B--ooXMT--|--oB-
-o?oXoBT?T--?B?-ooT-B-o-X-oE-|ToBT---E?---T?T-oE--Too?B-Mo--TX-M?T?E-EToo-TM|B-XBXB-E---XTBo?--TTo-TE-BT-X----oXTTBE-oT---oT-o--?--XooXT-XXTXM---?----?-oBM-?oMMoX-TT-TT------|TXT?|BEBEX|oTT-X-TMTBoTX-
---T----o--|?--MooTMTTXMTBMoMM-o|-TE----T--MME-E-XoX|--?X-|-?MBXTo-T--XE-|E-EM?E-oB?-TE?oM-o---TEX?-EXX--BXoBE-----E-XXXMM-M?E-TT?TEoTT-B--?oTTX|oTB--?o---TX-oTX-BMToEMX-?---TXBo-EB?o-o-MTEo-ooXM?XEX-
-Xoo?TBTX-TXoXo----MBMMo---?T??T--M?oTT-MooTTEX--o--MoBX-X-----oB-XBo?--??E--T--oX-Mo-----BMBMTM-XT--TTTT-T--o--EoEEXXM--B-BT-?oo--B--BB--T-|XXBTT-T?T-T-BXE?-oToXB-ToE--MB?-T--T--M-EE-XXMo---T-X??|X--
--?MM-?X-?TT|-B-EToBo---T-?-BBT-Eo?-oB-|---T---TX-oXo-?--o?o-To-To--X-MXM--BTTM-X-XT-?BT?-?---EE--TM-M-?X-?To-E-Xo-?TTT--XTB-oX?XM--E|TB-o-MoB--TTT---oTTT?T-T--TEX-XX?XToTTTMXTM?--TMToo-T??--BT--oMX--
-TMB--TTMETM?TE-Xo-X-?----|M---TT|o-ET|oBoB--TE-X-X?o-X--E-T-BT-o-Xo-BETETX---XTEXo-|oEBToXM-oo-o-o?TB?ETB-oo-XME--oT-ooo-MT-o-T|---To--TX--TET-To-?BBT-MB-?-XTT--E-TE-|-?--XE--X?--XT-XTX--TXoTE--o?-T-
-TX-?BT??BoX?XBT-TXB-ET-X--E--oXoX?B--TT?X?--TX--T--Bo?BTX--o?o-TEE?-T?T--?ToE---|T|-XoTX---?|?BT--T-X-oXoEoB--T---oTE-TXTEXBT-?ooTETX----TEBMB?-o-oooT-TTBo----BoM?o-Eo?-TX?-TMToTTTM-o--?-ToXT-oTB-Xov
-?o|-Too?-TB-E-T-B-BE-X-EM--o-oXTTB?-o-M--X-T--|BT-TTMT---XEBXToTT-oT|B-TT-o|BoB-|X??T-M--XXB|Xo-?B-T-T-oTB--X-T-??--X--T-B?B-TXT-T--TEXMXMTM?T-TT---|MoB?-XTXTBB-?M--?Xo----M-T--B-T--T?-B-T-TX-EX---Bf
-BM?T-TooET---o-MB--T-|TTX--B-XB?--B---EEB--EM|TB--o|oE|o?---Bo-XT-BX-XX-TTX?T-oBT-T?o|T-Xo--T---MTET-|TooTETBEBX-BX-T--XET---Xo|--MoE-BM-T-T-E?XoM-M-ToB-EXXT-T-XooXX-T--B-B-?XoX?MTooo|-XXTo-T-TT--T?f
--EXB--oME-|X-ET-oMTTEXEB|o--M?-XMET-Mo--TXTMTo------T-XT-MM-|TTT-T|T--T-EoToX-|TTX|E|oE-TT|T--EB-|X-oXB|T--M-TMX?---EE---|-BXX----T-XTo-B-EMB|ooTM-T---oTMTo-M?M-XB-BTT--T---B-TEEX-X-?EX-X-oT-?|To|oMf
--?--|T-|T?o-X--TMoTTBXXTT?o----T---B-XE||?--ETXM-o-B-ETooX-?MT-To-ooB-XXXX-E-BoXXTTM-T-T-X-oT-BT-BXo--T-?ETB-oT|ToBB-T|?oT--T-X-oB-TX-TT----o-ToXT??B-XX---?T-M-To-EE--X-BMB|?-??-o--TT-TEoE|XET---E--f
-?XXXB?-?-?XX?B-E?M----E-?-EEB-M-?BBX?B-XE-oB-EBX|?|-XX-XMXoX-X-ooMBo?B-?Xo--Mo-X?-o-o-E?-oXEM??B-??XBoB-Bo-B?-BB--XMEXoTXM--XTTX-BXT?-oXX|BXBBo-?--XEoM-BX-oMXB-MBoBEoB?-oBBXoB?-B--X-o-o?--BBB-E?o?-Ef
-XX-X?MEX-E-oMEXXXT??o-??BoM?XoX-EXX-X?-?--BBTX-X--XBoE--Mo-E-MoME?oTMX?oXM---oX---M--o-BXM---B-?oX-TooBMoX---oX-XXo-MTXX----?--XMo-X-Xo?-XBEE---X--o---B?oXo-MoB-oXoXE-XXoTXXMX-XMBBB-oE-E|E-?-EXM-X-Xf
m-MX|X-XX?BM--MMEB?Mo-X?BBM---B--MXEX-E-BXX---B-XB?E---E-XE-B?X?-X-B--M---?BXX?oM---oB-X?--Xo--XMM-M-X--T?-?BBX-?-B-XB-?B----XBBM-XXo-oMBME-?EX??X-?-oX--Bo?XMX-X---B?o-ME-o-BoX-Too-B-o?XB-o-BB?X-oE-BX
XX--XX-XX-XXXXXXXXXXXXXX-XXXXXXXXXXXXXXX--X-XXX--XXXXX-XXXXXX-XX-XXXXXXXXXXX-XXXXX-XX--XX-XXXXX-XXX-XX-XXX-XXXXXXXX-XXXXXXXXXXXXXXXXXX-XXXXXXXXX-X-XX-XXXXXXXXXX-XXXXXXXX-XXX-XX--XXX-XX--XXX-XX-XXXXXXX
