-------X-E-------------------------------------oX-------o----E---X------Mo-------E--?X----BoX-?-----B-----------oM------B---?X--------X--------M-------M------B-----B-----------EXo-----------oEX-------
-------o------o------------X-M----o---M--------o----?--------o------B------------?--B---o-----------------------E-----------BM---?----B---------?--o--------E-----o-o----M-o-------o---o----------------
-------B---M----?------X--------------------------?-----o--------B-E--------X----?------------------?-------------------E------M--------------?----B--------------------M-o---E----X-o------E----M---?--
---------E---------B-o---------------------XM--------------------M---o------M--------ME------B----------B------------X-----X------o-------??-------B--------o-----E--X-o---?-----------B---X----------o-
--?---------B----X-B----B---o-o--?-------------------?X-B----------------------o--E----------B-BBo-------------------E--B--------E-----------X-E-X---------BB--------------X-------Xo---------------M---
----o----B----------o---------o-----------------------X------------------X------E?------------o------X-----------------o----E--------?------------?o--------------M---oo------oBX----B---?-----o-----o--
-----E-----E------------------------------------?----E-o---------------------------?----o-o-o-M--------------------?-E-o--B-----------------X----?------M----------M-----E--------------o--o------------
------?----o----o----------B----E-----X----------o-----E---------o------------oB?---o-?E---X----------E-------o--M-o-?-------?-E---o--M-o-----o--------X-----------M--M-------------M-----X---o--------v
--------------------o--------------------E------------X-X----------------E---------?-X-X-----o-----------o------E-----E------------E---------------------------------------------EEo----------XX-------f
------?--------------------X-X-------B------------------------M--o--------EM---X-M-B---o----------o---X--------------oX----X-------o---o------------B--------------------------E-X---M--M--------------f
-X-E--------------------------o--------?----B--B---------?-oB--X--X-B-------M----------------XX-----?------X--B---X-----B--------------------------------------oM-?----------------M-X--B--X--B--------f
------------?-?BM-------E---------?-----XB----E-oo--X------M---------B------M------------oX--X-?B----------E------B--M--B---------------M---o-B-o-o---------o-----------Mo-B-------o---------------o-X-f
-----------X----------BE-o-?B|?-?T-XoB-T--T-M--T----T--TXXoo--------oTT--T-X---o----o---Xo-----T--EBXX-T-TBB-oT?|oB-|-----T-o-T-----??TT|TX--o-M---T-ET-o--E-T-?--oT-B------o--E-o-|--X--X-|-T-XXo--o--f
------?--M---T?-X---BM----XB-?-M------o?TM--X----MT--M-o--TTT-XoX-M--T-----o---T--?--B-B---T??-----T--To?-T-?-oMB-X---T?-----E-o------o--X-T-B----XE--?--M-MBM-??-X---|--BT------oBo----T-X-T?XXo-o?-XBf
m--------TM---T--EM--B------------T-----o---X--E----B--oM-?T---X-oM-----XT-XB----XoM-XX-----?X----MXM|-T-X|M--oT--oX----X---B--M---oTT--Bo-E---o-o--o---B|T-X--T-------?---E-ooX-M-EX-T--?X--oo---T-B--X
XXXXXX--XXXX-XXXXX-X--XXXXX-XXXXXXXXXXXXXXX--XXXXXXXXXXXXX-XXXX-XXX--XXXXXXXXX-XXXXXXXXXXXX-XXXXXXX-XXXXXXX-XXXXXXXXX-XXXXXXXXXXXX-XXXXXXXXXXXXXXXXXX-X--X-XXX--XXXXX-XXXXXX-XXXXXXXX-XXXXXX--X-X-XXXX-X
