-------M---Mo-X-T--T--EB--?------------|-----XX---X----oX-----T-Xo----------------|-B---E--T-X-----XT----TM-----T?----B--------T----T-----o---T----X-----E-T------------E----------------------B---M----
--B-------T--o------o----------T--B--o--|-----o----------X--------------Xo------?--|-o--------TM-E--X--MT--------?---T-M--B-------o?o-M----oX----o---oo--|-BX----------------X-T-o----------B--X---T--|-
---X--o-----------oo---TE---o-----------?----T--o--B--X?------------X-T--?|--o---------------X-X-X---TX---B------TB-T-------o-----ToT--T--B------TT------------M-----o------M---------T-----------X-----
--------------------o--XT--o---T-----M------------------T----X---T-B------M---------E-E----------X-----?o---|-----T----T-------o-?--------|-----M----?T-----------oE---------------------------?--------
--E----E-------X--o---------?---------o|----------------B-oT--XB------T-MT--T-----T---E---|T-o----------T-?--------------o-------------X--------------------T-?To--T-------X?-B-------o------------?-E--
-----T--T-------X--X-------------?-----B--------B------X----T-ET-----?--T--------E----M|--B-?--o-----o-----|TB----T----X-?-T----T-TT-------B---E-T----------o------XE--?-------------X----X---------X---
-o?---o---X---|T------?---?B--XE--E--T--oo------------------o-------T--TM?----T--------M---|------|-|-M-----X-T--?--?-B---T-TX--X--T--T----------B----X----------BX--------oT---o---o------Xo-------?---
--------------?-------E---o----?-------T----------?---E-----?--T-X-TT----o------------X--E-E----M--------------oT-T-X-E--TT----------MB------------------oo---o---------?--------T-----|X-----E------E-v
--BX------o-B----------T----o--E-------T------X--------------------B-------T-B-X-T---T--M---B----------oX---------B-------?------B?-|----|----------oX-T-XB----X----T----XM-TE--T--o---------?--X-----Tf
----------MT-B----B-----X-X----B-|--T----------T------T-------?-------EM---E--------------X---X-----M--B-------------X--T----T-X---T-----B---------o----------T--?----------------|-------T-----------Bf
----B-B---B------?---X--TM------------o-----------Mo-o--T---T----------?-------oo----o--T------T--o-X-X------X-?-?T-----------------M?T-?--B-X----X--T--o--|---o-----------T----M--------T---M--T--E---f
--------T-----?------T------------XT-------X---X-------M---------T--T-?------oTTT--X-E-?M------XE--------B-XE--T--|--|?--------TM--T-------o---------E----?---------o-------------------XT---Xo--------f
-B---o--o---B-------|X-M?B---M?Xo---XX-----MXB-?--XoM-XoT-MT-Bo-?-XX-M--TE?-Xoo-o---?-?-MooE-Eo-T-----E-X----------X-oXTXo-----T-?-T----E-M---?--Xo--M?--T--|-E--|--X--T---?---X?|-o----BT|T-M-o-T--T--f
---X--B--X------MXT-B-----T---B-?BMX-----X-T-T----X-X------o----M-----X??-B--------To-o----E-To-T--o----T--T---o----?--TXT---------oB-|-E--T---B--E-----?BB----?XT---?---o--?--------T-TBT-oB--o--T-B?-f
m-ET-------T--Eo---TT-?o--X------o------BTo-?o-----o-o--ToXT--o-T--?--?-T--BM|BTM---X-X--T--Eo---T-X-----o--T-E-X-o-|-?E-X---|--?--------X--------X|-M-XE-TT--o--o-----?-|-o-oXT?--MX----T--|-?--TM-o--X
XXXX-X-X-XXXX-XX-XXXXXXX-XXXXXXXXXXXXXXXXX-XX-XX--XXXXXXXXX-XXXXXX-XXXXXX--XXXXXXXXXXXXXXX-XX-XXXXXXXXX--XXXXXXXXX-XXX-XXXXXXX-XXXXXXX-X-XX-X-X-X-XXX--XXX--XXXXXX-XXXXXXX-X-X-XXX--XX--XXXXX-XX-X-X--XX
