------------------o----oo-B---?----------------------------E--------o-XE--o---X----EE------------------B-X---------o-----B----oM--------E-X---------B-------X---X--------------o-X--------------o-------
--?--------X-------------X--o----------o--------B---X-----------M--------B---o--------?-?---E-------------X---------Eo-M-----------------?--B-----M---------BXM----E----E----------X---B-BoM--o-o-------
-----o----------------?---E----------?--------------?---o?-o-X--------------X----o--M----X-------------------E-X--------E--?---------------?-X--?----------E-E----------?--------o----o----------M-X----
--------------E------B---?--o-o---------X-o-o--XX--X--------X---M-----------------------o-------?-------MB----oo--------------X--X------------Mo----------------------?----------XEM--B?--B---------?---
-------E-B--?----------M----------B--E-----X-------------?M-----------?----o-----XX-----X--o-----E-EX-------------oB---X---E----M-X?-------B---o----?-------------X----B------X-------------o-B---o-----
--E---X-------?-------------------------------M-----?o----M------------?----X---M-B-----------?-------?-------o----E-----?E----E----X-?-o-MB-----o----------------B?B--o------o-B-Eo-------X------------
-------------E----------------X------o---oXE----B-----------------X------B----B-----------X----------E------------------X----M--------X-------------X-o------------------BE-o----------o----Xo-------o--
-M-XEEE-------?---X-X---------?----?-------------------?XoB-B-----?---E-----X----o---------------B--?---M-----M--------?---------X--o?--X---------B-E----?------------------------o--------B---------X-v
---B--BB----E---------X------X----?------------B-----o--o--------------------------------B--B-----X------------X-------M--Mo?B-------------X?-o-------o-------o----------X---M------X------------o--X--f
-E---------?-X-------B-------B-------o---B------o-?--X-E----XX-X--E--X-o---o-M-----o---o----E------------------------------------o-X------X---------?-B-o---M------M---------o------?X-M-o--------XE---f
--E-XB----o-------?--------------------------------------------BX--B---?M---X---o---E--X--Xo?----X--------------X-------------M-------?--o-----B------X-------B---X------------o--B---------?-X-M-X----f
--B--X----o----------?--------o------------------------B------------E--------oX----B-X---------------E---M-M-------------?-----------------XE-o-------------------o---M--?B------------------B---oo-B--f
------o--B-?-M---X-----?T--o-o------o--T-?-E--?-X---?--T---o----X---X--T------MT--BM-X---o|?-|--B---TT-----ET-oBE--M--|o--XTTo----E-----M-EE-TTB-|----o-T--?-----BX----T-oX------T-----XB---o--T-o?--o-f
------|--|--|-XE---E-----||--B--E|--B--B-?-|--M|?--X|--ET|-E---|----XE-T--|-|E|--E-|-TE-T-B--o--|-ETE-B-|--oT-||-|o|-----T--TM-|---|--||--|---T|TX||-||M-X|||-|-E--M||M||--TT--|--||Xo|-E||X|E-|--||EB|f
m-----ETET|E-|||o-|M-|TT--|-|X-T-TX--E-X|-|||-|T-|M-----|?X-XTo--|---o-|-||-TE---|ME|-T|E|-T|||---E---o|XTM-|-------E||-TT-|----|-----|----------||-?||---|---Xo|-------||---E----T-|-|-TM|--|----E?---X
XXXXXXXXXXXXXXXXXXXXX-XXX-XXXXX--XX-XXXX-XXXX-XXXXXXXXXX-XXXX-XXXXXXXX-XXXXX-XX-XXX-XXXXXXXX-----XXXXXXXXXXXXXXXXX--XXXXXX-XXXXXXXXXXX-XXXXXX-XXXXX-XXXXXXXXXXXXXXXXXXXXXXXXXXXXX-XXXXXXXX-XXXXXXXXXX-XX
