---M----------------o------E--X----------------o-M---------------------o-X-------X-E-----------?----X------------??---------o-------M-E--------o--?-----o---X----?X-----?-----o----X------?---?---XE----
--E----------B---X----B-o----------------------B----?--------B----------E---------------X-----------B----E---X-------E-X--o-o------B-B--------------------X---------------M-------?M----X-----E--X------
-------o-B-B---o-X--------E?----?----------------o--------------M--X----o-------o-B----B-------M---------------E--------o-X----B----X---o----------------------------------?M-------------?-----?-------
-----------X-XX----------o-M-Bo---X---M?----oE------o-------------------o------------M--o-----B------MXo------M----------------o---------o--------------?-------------?X----o------------o-?--XM--------
-----?-----B--o---------------------B-----?-------X----EB------o-o-B--o-----X---------------M----------X------?----------oX-------------X-----------------------o-----B------o---?-B----X-------------M-
-------E------B------o-E-----------------------------?--?----?--o---M---M-X-------?------?--?E----X-------------------------X----------------------o---o??M------o--?----------------------X----B---?-o-
--X------o-----------o-oME----o------------XX--o-E-------------------MB----X-------?---------o--M--?-------------------o-------------M-o--o---o----X-------------M-oX-------------E------------------o--
-o--------B-------------X-o---------M-----B--------B---Xo---------?---------------MX-----B------o----------------?-X---------E---o-oo----------------MB----------------X-----o-----X-------------------v
-----------------X---------X--E---------------o------------B---------------------------M---------?-BM--o---------o-----X?--o------------XXB----E-M-o--------------------------?-X-E?--M----B------?o---f
--------X------X-E-----o-----------?--X----------B-------------------o-------B----------------E-----------M----E----o-----B--------EE--M--------?----X---M--------------------------------?----B------of
-------------E-----------E--o----------M-------------------------X--o--E--X---?--E---X---------------?M-------o----M------------?E--------------------------------X------M--X-?-------X------M---B-o---f
-E-----o-------------------o--?--M----B---M---o-----------------------------B------------E------?E---X----------------------------------------M----M------------------o----E------------------------B--f
--ooT-X-?---TX--?-|B-----BE?--X|--------o-----X--TXT--XBTTTE-ET-o--T-o-M-|-----oT--?--T-M--------XTT---Bo--X------MT-oo---TBT------B----------B-oo-------------BX-|To--TX------X--|--E-----T--TEoTT-B--f
-----|-oX---E--oBXTB--TT--EEX----X-E----B----T--------B--T--X--X-B-oE--o-o-E|-----|-BB-----T--o--oB---B--X-T-----------|--?-------T--T--Mo--o?----?---M--MT---T-X?Bo?M--T-------?----E-B-----E------T-Xf
m-------MEBo-T-T|--E-ME----X----T-BXM-----oBM-B--To--XT?o-To----------T---|-T------X---o-X?---?XX------------|T?M?T?-B-X-------o----T-T-oB----E-E?-MX-EE--T-|XM--E-|o-T-X-XMM-XBX-X----X--?--o---o-----X
XX-XXXXXXX-XX-X--XXXXXX-XXXXX--X--XXXXXXXXXXXX-XXXXX--XXXXXXXXXX-XXX-XXX-XX-XXXXXX-XX-XXXXXXXXXXXXXXXX-XXXXX-XXXXXXXX--X-XX-XXXXXXXXXXXX-XXXXX-XXXXXXXXXX--XX-XX---XXXX-XXXXX-XXX-XX--XXXXXXXXX-X--XX-XX
