-----------E--?---o?-----BB----------------X--M-------------------E--?---------------X------B-----------B--------------E----------X------------X-M-------------X------B--------o---------M-o--E--o------
-------?--M--B--------o-?-B--------------?-X----B---X-----------M--E------B--o-?-------M-------X----X-------------M---------B--B------------------M-o------------------------------X--------------------
--o---X----E--B-M------X---E--E-----?-X-B--------M-------?--------?-------o--------M----B-------o--E---------?----EX-------------X-?-------?------------Mo-E-------M--M-M-?----------X------B-----------
----B----B-----------------------------------o-B-----E--oE--?-------------o-------E------X-X-?-M-------B--------------BB-X------X--X-----o---------------------o----------E?X-----M----?--X----oB-------
----------o-M----M--------------?--------------------X-EX-o------XM-------------X-X----------X---E-------------EE--------------o---?-E------B---?--------E--B---X------Bo----X--o----------X------------
-----------------MM?--?------o----------M-------------------E-o--B------------------------------oX---------o-------------M--B----------------X---oE--------------X-----------o--B-----------o-X---------
---?-----B--------?--M-----?-------X-B------E------X------------B-----o-------------------E---E-----XE-E---B----o------------M-----------X--------------------B---------------o------E--------E---------
---------------E----o--------?--------M----B------------M---------M-----------------oo-----?--B----o---M----------?-------------------X--B-X---EB------------B-------o-------------X?-----o---BB-------v
-X----XB---M--M------------X----?---o---------XB-----X-E---------?----------X-?-----------o--M-----------B-X---E-M----------------X-X------------BB--M-----oXo----o-----X-----M------------------o----of
-o---------E?o----?--------------B----X-X----------------------------o-X-----o------------?o--o--------------------------------------------o-----E----------------------------o-----X-------?---M--Bo--f
-B-------o----E--------?---B----------------o----------------------X----M------------E-------B---Mo-?X-------?-----------M----------------ME-------E--XM------oo-BX----------B-?o----------------------f
----------?----------------?E--X---------B-------o------------B--?X------B-----M-------------------------?-------M-XB----E-----X?-M---B----X---X--B-M---------------------?----B----X----------E-E-----f
------o?-----T--T--?-MBX-oX-------BXTXTT-B-TX-o----T-------T----T-?-?M-T-X---|-----X-----?X?To----MT--o-E--E-?T-E--------T-o------E-T-o--BXB|T----T------------X-X--B--T-o|-----T-XT---o?-X---T-|--T---f
-------|-E--TX---||Eo-T-|-T-B-o||--o|-BXE|--E---|T||------T--E-X--|||----|E---|B-||-T|--oT-||TE-?|-|E---||X?-----E---E---|-TTM-||E?--||T-||--E-------T|o|E----|-EB|-T|--|-T||-T---|-E-----|M-|-||X--|-|f
m-------E||----XT--E|------||||--|-|---M-|--|--|-E-|-||-|-o---E|---o|--|E-||-|-o---|---T??X||T---X-|EE---T-E|---||-||-|-|-?------||-|TTT--|-E-o--|-|-||-E||----T|o|-|-E--E------|--T||E--TT----EoM-o|-|X
XXXXX-XXXXXXXXX-XXX--XXXX--XXXXXXXXXX--XX-XXXXXXXXXX--X-XX-XXXXXX-XXXXXXXXXXXX-XX-XXXXXXXX-XX-XXXXXXXXXX-XX-X-XXXXXXXXXXXXXXX-XXXXXXXXX-XX-XX--XXXXXX--XXXX-XXX-XX-XXXXXXXX-XXXXXXX--XXXXXX-X-XX-XXXX--X
