---------X----X-----X-?---------------------BB----M-?---E-X-------------o----------?------o-o----------------B-----------------------M----B--o------------M-B--X---Mo-----?Xo-B-M----------o-o-----MX-?-
----------------E?---------X--------------------E--o--B-------o--------X-M?-------------XX---MM-----o--?M---E---------------------X-------------M----?--------------X-o?---o----------------------------
------------------B----------X------o--E------?---------?------X-----B----o------X------?-----------X-M---?-------?--?--o--------------?-------M-o-----B-X--------BE-----?----------X------------X---?--
--XM---M--------??----B--?--E--?--------------X--M------o-M-X----?-----X------o-----M-----X----oo-B----------E-B-E----o-XXX-------B-o---BoM----------o?-----o?----------o-M---X-----------X---B-------o-
----o------X-------oo--M-----o----X------X---------E----X--o---oo---------X-----o-----?---o-----------------M---------------------------o?----------M--o-----E-?-----------X---o-------------X----------
-------E------------E------o--?-------------?-----E-------X-------X----------------E----M---o---------XB----------B--X-E-X-XB--o---------------M-o-----------------o--------X--E----?--X--?---------o---
----B-B---E----X---X--M-----oEB--------------?---------------X------------------M-------------------------M---o--M---?-----B--X-----------E--------B---------E---X------------------o-------?-----o-----
--------?---------X---------E------------------------------B-?-X-o----E---?-----E-----o-----------X-------------M?--------o------B------M--oX-o--------------------X----------M--?---?-o---------B-----v
---------X?-------X-----------------------oX-----o-E-B---E-----------X------E-------E-------------------------M--------X--------o------------------------MBEB----o----E--------------XX----?--E-------of
-------XB-----------o-------------------------------o-XX---??---B-----X------o------?---o-----M-X---------?-----B----X-Bo--B----X-o--------------------------oo-----------B-------X-o--------E-X-------f
-------------------X--------------------o?------E-------X--E---------o--oM------?---------------?o----------------B----------o------E-------X-M---X-------M-----------------------------o--------------f
--B--E-------------B--------o-------------------------X--M--------------------o-----o------X------------------B------M---o--X---------E--B?----o--X-E---------------?-BE--B----------?M--------o-------f
-XXT-----oTX--XM------T-T-BX-Xo-Eoo--oo-----TooT----?-??--B-----XT-X-?-TXXM----?---?-B--X-----B---TTB---?X-T-o---|---Eo----E?-M---?-TT--o-------------oXEBX?-X-B--T------X--T-E-|T--BX--TTT-|-------T|Xf
---X--XM--B-----M--M-?---T--??-----TBB--T-o----T--T-|?o---E-B?---o?--T|BX--X---XM-X-XMXT---T-------TX-TM---EB---oXo-TTBo-B-XXT-?---T--?oT-|X--?--T--|-----M-?-|---X--TXE-oX----o--T--T--T-B-o-T-M-?--T-f
mB----T-T?---oT-X-----X---T??---T-Bo---?-B--?---BM?-----XT-B--XoX------MM--??o-o----T---To-BT?---|B-----T--|?--M-TE---B--E-----T?---E----B--T-?o-oT--|T-T-TM-EX--XE--X-X-?T-T----oBT-|-o-----?-T-----XTX
XXX--XXXX-XX-XXXXXX-XXXXXXXXX-X-XX--XXXXXXXXXXXXXXXX-X-XXXXXXXX-XX-XXXX-XXXXXXXXX-XXX-XXXXXXX--XXX-XXXXXXX-XXX-X--X-X-XXXXXXXXXXXXXXXXXXXXXXXXXXXXXX-XX-XXXXXXXXXXXXX--X-XXX-XXXXX-X-XXXXXXXXXXXXXX-XX-X
