---o-------X--M------------------B-----------------------------------o--------Bo-BX---o------X--o?------X--B----X?----------X-M----------------------------o-------X-o--?---o-----M---------------??----
----X---------oo---?---B----?--X-----X---------o--------------------------------------XM--X-----------?-----B----------X----------------B----------------------o--E--------?Xo-------o----oo------M-----
--X----?-------------------o?---------E--------------------------E----?--------------?-?o---------B--oo--E---------o-----B-B------EX---X-----o----B--------o-E-M-B----------------------?---M-o---------
-----------------M--------?-------------------------------B---------E---------M---------X-?--o--?EE-------o-----------------X---o--------------E--------------------------------------------------o---E-
--E---------------------X------------------------------?-----M----------------M---------------------MX---E---X--E--B---------------------M----?-------------E-X-----------------------------------------
-------------M--------?----------------------------------------------------------o-----------B-------------------------------o------------------B?-------X-B?-o-------X---o----------B--o---X------E----
-------?---------E--------XE---?------------------M------------------------------?-E-oX---X---M----------------E-E-B---B--------B-------X----?-?X--------------E------------------------X---E------X----
--------------------------------oo-----------------------------X-B-----------o-o--------oM----------EEX-X-------------------Xo----------------------------E-?----M-E-----B--------------o--M--o----M---v
--E--X--Eo---------------------B---------------------X-------------------o---------MoX-------------o-------M-----------------------o-o---X--oM---------------E--??-o-X?---B--X-------------------------f
---o--------------X--------------X-XB------------X?----------?-----B----?---------------M----------E--------M-------M--------oo--X---?----XM--------------------X--o---X-----E-------------------XE---of
-----------o------?o-----------------B---------------?----o--------X--------------E---------------X------------------------E----B----------B------------------------------------------BB---------------f
-----------X----------------M----------MX----------o------------?--E----------B----XX-o-o-----E--o----?-?-----------------X-------X-o----------o-------------XM------------X----------BoX---------E----f
---------------B-M-X------?-B----o--E--------M------------X---o-?-----B----EB-oX-Mo---oME---M----o-EXEo----BX------o-o--o--B--B------XXo--X---E--X?-X----o---MM--o-----E?-----B----X-----XX-M-----X----f
-------XM--E-----E-B------o-E--X-E------------------------X--TT-E-----B----TE--------E-E--------T-T--ET-----?--X---XTB-----MT?-------o----------B----------T--EoT----E--XET--M------T---------X--T--X--f
m-------o--T-----E--------oE-----o-XT-----E-E--B--E---o---M-E|-?-|---------T-T----B-X--E-X--XT--|-|-?-|----------T----------|o-oT-EE-----?EEX-o--------X---|B---|?------M--T------To|-X--oT------|-o-MoX
XXXXXX-XXX-XXXXX-XXX-XXXX-XXX--XXX-XX-X-X-XXXX---XXX-XXX--XXXXXXXX-XX-X-X--XXX-XXXXX-XXXXXX-XXXXXXXXXXX-XXXXXX-XXX-XXX-X-XXXXXXXX-XXXXXXXXXXXXXXXXX-XXXX-XXXXXXXXXXX-XXXXXXXXXX-XXXXXXXX-XXXX-X--XXXXXXX
