-o?-----M---|----M---M--M-M--|--EMB?--|-??---X--------o-TXo|-M----BB----B--?--M---|---|--B----?-|-X-TM-XX---BB-T--MM|--E-?--?--|--X--------T--TM-BM--??--B----MM-o|-TX-?---|o-X?--B?--M--MT----E-E--E---
--?-ET---B--M---Xo?----o-----|M--------------XT----E--M--|?-o?-oT?--BX-X----To-E--E----o-----|---o---M?--MX-B-----XoTT?-T----MoX-M----T-TX-B-----MXT-------?----M--B?------BM--o---E--o---M--M---E-----E
-----T---E-B-X-B-B----?--T--|-X-------?o-M------X----o---E----------T--T--TX-?-?-----?T-E--E--E-------o-E--X--o---T----------X----X--E--XT---------T--B-|E-----To------X-|--------o-T-MX-Eo-T-?B---T----
-B-X---------------Bo-----oX----|-X?o--?-B-X-----|T---|-----o----M--X-----M--M---B-|---XB-TX-----|--?-||-B-B--BM--oB?M--M--|-B------X---o--EMB----------T-------X---|--EX----M-BEB----|-------?---X-T---
----BBM---o----TT--|-|-o--MBB-|M----T-?-?B--E---o?XT--B---o------E--EE---M--T-T--M-|M?---B-T-o|--|-Eo--?B---BT-X--TT--------E-B-M-T-oXT----|X----?--Eo--|---|-M-----o-MB-BM-E-?|---T-o------X--M|B|E-T--
---TXEM-?|-------o--------E---?--o------?-?-E-|----T---oB--E--X---|EBo?-?--X--B-X?||------|-------XM----X-B|-------M|-X--B-EXXo--ET-XE-?--T-?---E---X---|E|-----T--M--|-T--T---TE-|E-|-o--EM-----TEM----
-B-EM-E--|T--|---o------X--?B---B--|-----X--B-X------|-B?-|-?|-E---|B|B-M---T-----X--T--o---EM-ME---B--X---------o||-B-------M-?-M|E--X--?o---?|-T-----XM--X-E--BT--M-|B------M--|-?-o-X--E------T-|Eo?M
---T---?-|?--------E----oo-E-----T-M--M------E-T|-----oo---E|-B|-----?E---?EE----|-oT?E--To--|o-oB|----------M--o------X--T|----M-E|--------?-T-B-X-T-------ET---T---?----ME?M--M?---|?XEM-o--M-o---EXo-
--oEBX-MT-E-|B------?T----E---B--XX---|-X---E-To|B--XB-B--To-?---Mo-|---?-T---|---|--MTB---EE------M--?|--E|?--?E|--BB-?-M-E-M--|-M?----MoMXB-M---oX----BT---o----BMM---EM-EX--BT-B|-----------------|B-
-X?|-M?---B----X-oTE--T----?-M-E--X---M--------BM---------oE--?--o-T-o------|X-M-o------?--M-M-----M--XM-?M---XT-------X--------o|----M--X----T----|-?o-----oMT-?--X---|-T---?B---o-XB-------X---M-|Bo--
---|X----T-------B-|T-----X-X--B----E-?-o--|--E|-?--B--E-?---B--------E-|-?Eoo-M-?--------?--B-?oXM-|-T--|B-|--oMBX--?---M---|?MB-|------X|------X----?X--M----|EMX-------o-XE---?--B-E-?T-?M---BM-TT---
--E--|-T--E-o---|--|----M-E----X|-|---|?-M-------XT---MBB-------EE-|-----EB-T---T---?-----B-----|-EoXE--TT-T--?----B---M?--BT-?EM--X---T-?--E---o-MEo---oB--Eo|---T--TT-----?--X--|-|X-B---M--?o-|-|E--o
--B---T-B-B-?|-M-T-|-M--T--X--EB----X?---TE-o------?--?------o--T------M-M--o---M-M--?----M------?-----T-M--B-ToT--|--B--X--XX----M-E----o---------?---B--|--------X----E---X----X--o--T-o---Bo---??-X?-
--o--------B--BX---Eo-----BM---oMT-B-?--X----|---------T-----MET----B-o-X-M-----o---E----?o--B--?E-E--E-B--TB---BTB-|?-----EB---EB--B--X--o--E----o|-T-|-X-o--EMT--------T--XTX-------B--------B?------M
---X----B--T-o----E---------M-------T--Mo----XT?---Bo-X---B---X---T-X?TBB|T-------|-|-----MT----M---?-XEo--|---B-?E------|M-|--ooEXX--o---------MT------??-|XX---E-Eo|-M--o|-?-|---M|-X---?-M-MB---X----
-XXXXXXXXXXXXXXXXXXXXXXXXXXXXXXXXXXXXXXXXXXXXXXXXXXXXXXXXXXXXXXXXXXXXXXXXXXXXXXXXXXXXXXXXXXXXXXXXXXXXXXXXXXXXXXXXXXXXXXXXXXXXXXXXXXXXXXXXXXXXXXXXXXXXXXXXXXXXXXXXXXXXXXXXXXXXXXXXXXXXXXXXXXXXXXXXXXXXXX-
