----------------M---------------B-------------X----------------B-----E---X-----B---M-X--?-X----------B?--------------------------------------?-------------X------------------?-B-----------XE--Xo------
---E--?---------X--o--------------oBo---------------------B----------------X----------X--XX-?--?o---------------E--X-----o--o-------B------B-------o-----------?--------M-------M-o-M----------B-----B--
-------BoE-----E--?---------------M--M--------------B--------B-------?--------------------------------B----o---X------B------------?-------B-------------?o-EX-o--?X-----M-------BM---------------B-o---
-----------?-E-X-X----------------?----o---M--B------------------?--------------------X-------------XX---------M--------X-M--B-----------------B---B-----X---------B---------B--M----------oX---------o-
------------B--B-X------E-----o--X-----------------X--?--E---------??--------------MX---B---------------------M---------oB---------------------E--------B-------------o------------X-------?------------
-B------------MX-----X------?----------E--M----------------o?-----X--B-------M---------?--------E-----------o---------X------X--X---------------------------E-X---M----M-----?--X--B--------------Mo--B-
-----------E-X--------------------B---X--B-----o-----XM-oMX--o-E----B----BM---------E-----ME---oB--------E-E------??--B---------------?X--?------?-o----X--E--------------------o------o----E-----------
-----B----------B--------------------o------------Eo---------o----------------------------M-o---------------------------------X---------o?---Mo---X--E---------X-----M--------------------M-------B---Bv
-------o---o-M-----o---------?XMB----------------------M---------------X-E--?o-------------o-?----------X-------X-------------------------X----------------------------------B--M-----?--BE---o--------f
-oX-----------------o-----?---------o--M----------------------------------------E------------------X------?-------X-------X-------B-----M--E--XB-----Xo--------M----o-----oo---o--------M-----o---M----f
-------------B--X----?--X---------X---------X---------------XX-M-------E-------------M--MM-E-----------B-----?---o-----------B---------?-----X----------o------X-o----B----M----B-------X-B------??---of
------------X---------------------------------B--o-X----B------o------X-------M-------------------------B--o--o---B--------o--------------------------------B------o-----o-X---------------------------f
------B-----BXTX---------oTEB-?----XT---BT--X------?---TTo--T-E------TBTX-E-|--------------?M?----BBXX-X?--B?--M-TT-o-o---T|-?T---?-XBTT---TMB---?-M-EoXT-?B|--oo---MBo--T-ToM--o-----X--EE--B-----TTBTf
-------T----XB-M-X|-----M--o-BTo-|-|BXo-TM-oT----M-TE|-T---T?---?-o-----?----XE?--BTM-B-?-To?TT-------TT--T--X----B---T-BBo------T--oBE--?To--T---T---Eo-o-T-o-o--B---oo-B-o-----oB-----T-oBT-T-oEo--X|f
m-----X-----oM----E-E--X-X|-T-T-T---B--MT--E?|T---X-----?--M-T-----o-E------B-E--To--------X--o-o-M-MTTB-X--ET|--MT---------B-oM-----oX--T-----X-o-E-T--MTETE----o---X-B---------E--TB-T-B--B--T--XXTM-X
XXXXX-X-XXX-XXX--X-XX-XXXX-XXXXX-XX-XXX--X---X-XXXXX-XX--X-XX-XXXXXXXXXXXXXXXXX-XX-XX--XX----XXXXXXXX-XXXXXXXXXX-XXX--XXX-X-XXX-XX-XX---X-XXXX-XXX-XXXXXXXX-XXXXXX-XX-XXX-XX-XXX-XXXXX-XXXXX-X-X-X--XX-X
