--B-B----B---X|T--EM?--TB---MEX-------o-E?-|----o--B-|--|M-----T---|-|?o------o|Xoo--|M-----E------T-------B-oX--?---X--------E-TB------------?----T?---T|----|XoTE-X----T--?-T-E--B--o---X-o-o-o---oM--
----Xo---oXT---E---ET--X-E-B----B-E-?-----E|oE--?-X----?-|---?----o-M----B-------oME----o----|-----To-||oE------M---------|-X--|-T---X-T----|-|--EE---o---B|--X--EX----|?----B---oB-----oXX|----?-------
--M--?--?-?-----M--E------?B-----To--B---X-M--o--Xo?--Bo-XE--ME?-EXE-E-----?M|-|---oo?E-------------o-B--Mo-----?o---X---T?--o---?-M--M-------?--------|-E?B--M-------?--EBB-B-M--E-----------------|Mo-
--|T---o--oTME--XTEE----EB?-?T---To|-o--?------E------XB---MEBM-|-----X-B-E--BT--ME-o-T-|MX-B--X--M-T?|MBMB--T--?-|E|B------?-o-----B-----X?-E-|----------------M--M|--T-----o----T--|M-|-XB-B-X-----XE-
----|--EX--oE||-E-B-X-?X--X-X-?E-T---E---o--E--XX---B-----B?---?B-B-?---X--X-----?T-------?o---?---|oX?B?------o----?|------M-X--X|-?o-oE--X--E-|M---M------?--------------MT------?---|--oB-EXMooTE|-o-
--B---------B----M-----X-oM|----XM---o-B--T--o?-B-?-o-?M|XM---?XM--X--?o---|BBo----BM---E--|E---X---o--T--X------X-oE--o---|---BE-B-------BX-|--|--TE------E?-B----EBT---Eo|-o------B|-----E-B--oM---M--
---E-?------|-oXB--?------------B-----E-?---|---------|-X---?M-M----XE-----B-BMT--BBMT--ET----------E|---E--------M----T?------------X---EoT-----?o-|-----E---?M-o------o--??----|?-X-BBM-M-?--T--Mo--?-
-|-|E?-E--E-?XB--?----E---------BEM-E-||?-?X-E-----X---o--B-M----E-----?----------B----?---?---T----To?E---?---?--|B?--o--?---X-oB-M------o----?--|E-ETE--|X-M-X--|?--B---TXE-B-----M----X-oXX?-?-B---Mv
-E--E-E---o---?M-|----?--B--M-----X--------B--B----?--?---XT-M|---T-----B----E-T--|M-?-------MT---|?|--M-----TB------EX?B--ME-MB--B---B|-B-------E-MMB------?-?Eo---E?T?o-|X--||TB-XX-B-----oE|T-----MTf
----?----?|---XMX||E-o--MTM?T------E|X---?--MBT-T------o----------T-----------X|--T-M----T-TT?M----?-----MMM-Eoo---|X-E--?---BMo|o-o-X--E----M-------?o-T---Bo-----XT--E--o-?---?o-----BX-|oo-|-------Mf
---T--|T--MB-B---|EX--ToM---T-E------MX---o---|-X---T------o--MBX--E--------E-E-o-|--o--M----|--T--X-B-T----|-T----X-----E-X-E--E--|X-----M--?------B----?M---E?-T|-o--o--o--M--?--o--B----BXT--------|f
----X-MB|?----|----B----T--EX-T----B-|-o|---BBMMX---oMX---o-----X---E-EE--T------E---X-|---M-T--T?--|----X-?X------||----E-----EB|------B|-oT-o----------|o|-----E------M||-B----TB-?-|----M-XB-o---M--f
-o-M-E-|--------?------MTE-------|---TM?-X-----M--T-X-------------T----E-EBB-MX---M-ET-T----E--o-----------?Xo--o-B---EX--|E-B?--E-----B-MXXB---E------X--?-?-B-?--||-T?M-o-----|o--MM---?--M-X|To-?---f
-T-XE--T---T---E-B--|-M-??--?-X--X---------?---E?------------?-----|oT--M---|?--XE-------B--|XX|M----T-|--B----X-?----------M-----??-------------o---EE-MMB-|---T---E---------X--E--o--|---BM|--B----o-f
m-XE--MX--o-------B-|-o--------?----?B---------B--X?-|?-?T---E---|XX-TXT----XB-X--?-X-?---B-----M-?-|T--o|--T|B-EM-----Eo-M---------T-|----X|---o----TTT?M--?E-|-oo-|---?--o|-To|?M----oB-------?---|-BX
X----X-----X------------------------X----------X----X----------------X-----------------------X-----X-------------XX----X---X-X---------------XX----------------X--------X--------------X---------------X
