---M-----T-----X-|--?-B|-----------?--?----X--o--|-B-T-?|------MM--|--M-B---|BX-----E-|-?-|--B-o----B?-|-----X-o-T--|-----|--BM-----|-B-----------T|M------?-----o------o?--X--|-M|-?-?-|B---B----?X-X--
-B-oXT-M|--?-|o|-------------o-?-Eo----X---X-------o------T----BM-T-X----------M--B-M-?----|-o-B?----X-?---------XM----|---E-M-?---M---EBX-T--E-o?|-?-E-|o-TT-|o---T--|-------T---E-----E---MoEXEo----B-
--E|T-To||------X-E|?M--B-M------M---o--B------|---M?TB--o-|--X-Xo----XB--E----XT--|----o---XT-T|----o-XT---M?o------------||M--E--------B-B-o--B---E--------X-T-------TBo--o---B------X---X-|XX--------
-EB-X--B-----TBEM??--X-?-B--|--B-M----X---------T------B-----XTT-MXEB--X---|T--M-?B------BB-?-B-----T----B-------?-E---EoMB-X--T-|--?--------|T-B|---|TT--|-Bo-ET-X--MB-------Mo?-X---B--o-T?|-----B-?E-
-T---o?-TE-X--o-oX---|-E-||-T--o?-|----o---BX-X--E-|-------oX--------X-----E-M--o--X--T-----B---?-E----E-XT---E-BE---B-E-||-B-T-EB--?XE-----B----B---M---------B----?----B-oE--T---MM|E---ME----------B-
--B-M-|?-|----MM-X-----oB-o|--M-X?-------B----M---?-o----M----?-E-?--?--o------X--------|---|TT---T-X--|---M---X--|TT-----o-EB------E---Xo-------o--TT-?-?--M-?-----|--|T-?-|-------E-----||E-X----|----
---o----EE-o----X-o|-XE-|-|?--X-X----?|?---M--?-E--M|----X-----ET---|---M------M-B--M---X-ME-o-X--|TB------M---o?-TX---M---EB--XME--X-|--------X--o-|-----?M---TB-?--X----E?---MBMo--o----o-E------ToBE-
---EX|----B--B--oTE--B|--T--X?-------------|B--E|-|?--B---T-?|M-TM--?M---||-M---BoEB-----TE------------o--B---|------X--o---E-E--M--B--o---T-BM-----M---|Mo-MTT--X--------T--E-EM-X----??--|--o------M|v
------------|-----B---EME---X----|o----B---X----B--o--?-?-M-B---M-----B---------B|----MT-B-o-MT--?B--BX---E-----|o-T---EB-B|X---------|o-Xo----?--|X-----EM-MM----|X-o--?T?-----||---TT-XE--BE---?E--T-f
-|------||---M--o-?T-M----XET----?ME----?--T--X-----|o-ETX---?---M----|--|o-----EE|M-T-o--MB--?-E-------E----?-T|TEo|-T------------MoM--T|---TB--?-XE--TXMXTB---o----?--------MM-X--Xo|M--X-----oo?--BMf
-|?-oX--?------B---|-oM------|-M-B-|---X---M----?--XX----o---Too----BT-------------EEXBM----|--T---E----T----B--?--TT-E----|----?T-M----E--?-----To?|T---B--E?----E---?--||-B-oM-T--|E--B------B----o-?f
---|T-X-o-------Bo--?T-o--XM?T-T-----To|---E---X-?-?---------oT--M----?---T-E--ET|-T---BE--M?-?---X-----B-BM-M--XMT-E|B|-|-?-T---------T-B--BT---X---?B-E|-T-Eo-X?---M?oM--B---E----?--B-oT?--o||--B-E-f
--|o|----X-?--X-------E-T---E-X---o--?--oME-XX------------||METM-------ooT-----E--E-BMTMB--B-X-B---M-oXXXoT----o--------MME---------E--T--E|T----B?E--o|---B---E---B---TE-Bo-BE------o-?-|--|-E-M---T--f
--X----------M--o|----TE---|---B|---------EB---T----|XE-MB-T|-XE---------T----X--oT-E--o?X----B-------------M--T--X?-BEM---EMB---BM-B-XM----E-To|---T-B--------o-B---|-MXB?-------o-B-------X|---|-Mo-|f
m-XB-?MXTMX--|-----??-M-M---X|-o---X?--B-XX-E|--TEB?----M--|?E----|--B-------E--T----E----B--||------X-----EBBE-|-T---------|?X----X-?oT-B--BEM-TB|M-X-B-TB---X|M-----|-------EB-?E-------T-E-M----ooM-X
XX----------XX---------------X----------X----------X-X------X---------------------XX------------X---X-X----------X---------------------X-------XX------X-X-X-X---X---------XX--------X---X---XX-----X--X
