--M-----oX|-o---MBB--XE|?-XoB-E-ooX--XX?-E--MBM-XB-XB-BoT---oE-X|X-oBTEBX-X?EXXB-?o|-B|T-B-T?BX-M-X---?-----BM-|--X|T----------X|-?BE----X--B--TEM---MMoE-B-?o?--BXo-XEE?X----o------?-BBBoXo-Xo-MTB----
-B-T-M-BXEM-BX-X-|E-?B---Mo-?---|B|B-----Bo-B|-E--XB-?BB--?--?--B-?BBBXB---BToXEXX----?oX--BX----|B-XEBX--?E--?-X--?X--?TE---oB--M--M?EMB?|Bo-BB|EMBTM--X|oBM-----X----E-X?--MX-?E---TB--???-BB-T--M----
-B-B-X--T---EoEE?BBE?-M-TB?M?oM?-oE-MXXMXMME-M--oo-|B-M-o----o-EBXB--o?---X?--X--BT-XTB-X|-?B?-M-Eo--Xoo----o-B-B--ToEo-----BXBEoBXBo-?--XXB?o?-?-X-XXX-X-BXBB-M-To|X-XoBXX---X-BXM--o-BEEB--B--M-ET-?T-
---T-?o---B-o---B?--B-Xo--X----oXBMX-T-o?-o--Mo-oB---XM--oo-MX?oooBToEo-T|-XTB?o---o?Bo-X|-o|--oMB-Xo-X--Mo-M|--?E-?X-E-|--MXE-?----||-Xo-MX-XE---|---BX-MoT-E----XET?--X-?--M-BBoM|B?E-EoX-E?--o-XM-BX-
-??---XB-o?B?|B-|--?--XE?-BB--BXooX-?--oMM||EB?--?-----o-?oM------|-M-E--XEoE-BE-X|?M-X--X-???X-M---EB-B--B--T--M?E??TXX---XMBoXoMXB-o--E-TX-?-X?M-XT?-MXX?-X-|?XX?Xo???BB---?|--BB-?o-T-E-o---X---X?---
---oT-?XMXo?-?B-B?T--BB?--o|T-BM--?|o?-BB-B--B--X-X?-X-o-B---?-o-XBX-MT-?-EE--o-??-B-M-BX-|--o?-MEB-BM|oX-?|Too-X-|MXX---MX?oTM-BMoTBE-Eo-||-XX?BM---X|-|B-----?-T|?E-X?-XXB--X-o----M?-T-----X--E--o-o-
--?--X-o?--------oo--MTX?BM----?----T?--Bo---|o--|-X-X-M-----B--oo?X?XM-MT--M-BXE?XoBE-M-X---X---?o----??EoX-|B-EB?BM---?--?-X-oE--M-o--B-oo|-o?-o--X-M-?X?-T|o-----B-T-T----BBBo--X-X-T-XoTB-B--BXB?-M-
--|--Bo??|B-oMTMBBX?-?---oTE----?oo?TXo?XB-oXE--Bo-|X-XTX-?X|Mo-?-?B-M------MMoM?-Xo-EBXT-XXB-X-B-?--o-X|X-X-X??-X----?-B|o-|-X?oT-XB--MM---B---E-o-----BT--BXEB-?--o-B-oE-X-oB?-T-EXo-M--BoX-----?--MXv
-o-E--MT--E-?--o-XT-XBM-XX-T--M-E--X?-|E-EXoE?X?B---E?XB-XoE--oMT-o|---XT-BE---B--Bo?XE-oE?-M-M-E-oXM|---|M---BX--B?BT-T---M?M--?XM-|-o-BB------E?--BE?X-M--B-oEX-M--BX---B|BX--XBX-?T-?M-BoXMo-XM-X--Bf
-M-M-|--B??-EXB--o|ET---X-B---o--B-o-XT|M?BXo|-Eo?oB-M--BEBoM-|-E-E-B?|-BEXMB-M-XMXoME----?--ETX---M|B--o-o-------M?Xo-M?ET--XE-E|MEMB---XBoMBB-X-----X-X?|-o--ME--E?|Mo-B-M-BX?-o-X?-X--?----XX--?--X-f
-?oX-BE-X?X-B?--MXT---X?------BE|?B-EX-|-T----BX-M-M?BBXXB-M?-?---?|oE-?-XE?M?M?MoX-MX-BEXoBE--o-o-|--?---X-EToo-?X--oTB-Mo-M-X|-X?-?X-XToBo?E?-o-XXM---TB?oB|?-XoXM?X-?--oX-o?----?X?B|XXMB-MB?--E?--?f
---TX|------??---BE?--EXo-TX--B--BM-o--B?BME-B|?B--o-EE-oEEM---|--X--?-M--M---E-XBX-oE-B-?-?XXBXoM-?X--X-B-E-X-B??BMo---M?T---|-|-Xo--Mo--X--E-Bo-XXM--X-oB??X-XXo----?-?-X--B-X-XB-?o-XE---BMX???M--E-f
-?MBM-E--o---X-X-E-E--M?-XBX-XB--oE-o---ToMX?BE-TX-BBXM?B--B--X-BEBBMB--X---X--Mo-BX-?-?Xo-o|?XB|MX-------oX-Eo---?-T?-B?-?o-??-----oB--EToX-|--TT--?Eo--BT-??--ToME-T?----BEXX-M-X?-B-?o-XBX--oMMTM?-Xf
-M-?----X-BMET-XXX---Boo-BE-Bo-TX--?-BX--EB-?X---X-Eoo-?---oE---?---M?-X-B-XoX|Xoo-o----|To--o-|-|-X-T--o-E--M--|-o-XoB-?|X-oX-M-?-?MB--o---?-T-B??XB--oo?--X-EX?--E-TE-B-|?oEo---XEoBXEM-XT-o------BX-f
m-X-?-X-X--X---TX|-ToX?B---X---M?T--M-E-o--o--B-M-?B----T--?-MB--o--XX|----M-T-X?-MTM?MX|T-o-X-M-XET--B-EXBoB--B-MT--B---M-?-M--?EB?EX---ooo|o----?X------o|B--Xo----?EXTo---XTE-X--M-B---oX---XM--T-o-X
XXXXX-XXXXXXXXXXX-XXXXXXXXXXXXXXXXX-XXXXXXX-XXXXX-XXXXX-XXXXX-XXXXXXXXXXXXXXXX-XXXXXXXXXXXX-XX--XXXXX-XXXXXXXXXXXX-XXXXXXXX-XXXXXXXXXXXXXXXXXXXXXXXXXXXXXXXXXXXXXXXXXXX-XXX-XXXXXXXX--XXXXXXX-XX-XXX--XX
