----Mo------B-M--------?--T---E--|-oE-o--oT------BX------X--T------?-?|--EEB-B?-o-B------M-o----------M--o-X-o-o--M-M---XE----M-M-EX-|X?-TMoX|--M----B--T-X----|-Bo---|--X--M---|---o|-o---??-T-X---X-E-
----M----------X--M--To|M--M|-o---TME-X-o-?X-TX--|o?--XT-----M-M??-----MET----|-?-----E-T---X-B-B----BMo-E-XEoT-----MT--o---|--T-X--|o----E---?------------E-oTM-ET-BM-?-T-o-?-M--E-T--X-|----?o--?----E
--E-?--?B-----E---B-?-T---M----X------MMTB-M-To?--T-----X--?B?o---X-E--TMX--|------ME-o??----E---ME---T-?EME----M----?--B-|--E-----|To-E--E?-E--?-----T--?----?---T---o-|-|----M--MT-BM-XB----T----?-?--
---MB?-----E-X------------Mo----|??XETM?B-o----M-oT-B--E----XB-o--------|-T-EB-----|---E---X-o------------oX-----X-------oEE-?T-------?|?---B--o--------o-B-E-B-----E---BXM---|-----X-o|B-oXT?XX-M--o---
-TT-M|M---?|--XE|-o-T--M---B?-?o---T-o-|o??|---?B?--?MB------X--?B-MTX---?---o------X|T---X-B--E?Eo----|--?--E-M--X---ET--M----------T---|------o-oT?M---------T-o------?-?T------E---------o--MX?X---|-
----?-T--X-M?-XXEo---?-X?-|o-B----M--T?-B-EX---BX---X--T--------X-EE-|-------?----T---E--M-B---|TXM---BT-----M-B---------M--M-X-o-E-------E------?-|-XT---T-Xo-X--M--?T----E----E---o-T--o||-T-TBE----X-
-X--Bo-?o--o?------B-X--B-X--E---|?-M|-To-o-------?--|MTo---|----X--M-?---T-M--MME-T-|-o--oXE-----|-XTM|-B---MoT--E-XX-B----|------|-------o--------|M--M?-|-|----M-E?------X-----BMoT-T---o--?--|-ET-|-
-----o-B|--||X----|E|----M-------oT|----M--?-|------|---?--T--M---ETE-BX--M------E-|E-----ET--?------M-o?B-E--?-Xo----oM--B---?--M?|-X-----M---|---ME|-?o----|---T--B-E--T-|B-X--------X-M------Mo?--?--
----T-X--|-E----E-T----MMo--|-|X-----BE----B-----o-o----E--E-|E--E-|-|----|E-------|XEB|-B--||BT--------|----?---?--E--------MB--Xo----E-|oT----o---E------E-----------??oT-----M-BB-----B-|--B-B-------
--M---------|---o--?--T----------X-BB--T----B----M?|---T--M--M-----?----o--X-----------T-?--E-X--E-M----T-E--|---B----MB-B--|-E---E--Bo-----E---X-B--|-E?--BTo-E--T?|-TX--TET-T-||-X------o--BE|---M----
----MB----B---M?----E---BE?-?---BEB-BM-B---B-E-T--X?-----T---------B-B-------oE?----M-oB----B?-M-o-------E------X-B---M---|o---|-o-M--T--X----|-?----E----o-|T?oT--M----?-?--T-----|----E-------??E?BM-|
--B------T--B---T--XM-E---|---M-|T----EE-B-?--T-|----B---?---o-T----|---ME---T---XE-?-----M-X-M?--B--T-TM--TB-o------M------??--E----|-BE-TM-EE-----oT-o------?--M----|--?---E------o||M-MB--|-|-X-oBT-o
-?B-|-B-X-|X---To-|-|---M--XT---BE-ooMEMo-?----|-M---EoB-M?X?---EBToX---o----T--------------|--------------EB-oXE?o--M---T------|-E-E--TB-o--|-----E--T|-M-o-TMT-M--TBo-T--|-----------T-----?X-o--?E-X-
--EX--E-?-X----XM-|-----E-o--E----|X?-M--X-----------T----M-E-EEX---T---MT--------?-E----------T-M|-T-----E-------X--?MB--ToXM--E----M?-?--o-E----?-MM?EBoE---T------?T---Eo---?------|--?--E-?--MB-----
-------T-?T-B-B--|--------B|-XTB--|oT|--?--Bo-E--TXX--XBBM--o--|---|-----XXE----o-|B-MMX---EB--o------X-o-E-|M|XoEoo--|oo|B?----ET--?|-----------X---?-BM-?E--X?EB---T-|B-o--BB--MoTB-------To-?------M-
-XXXXXXXXXXXXXXXXXXXXXXXXXXXXXXXXXXXXXXXXXXXXXXXXXXXXXXXXXXXXXXXXXXXXXXXXXXXXXXXXXXXXXXXXXXXXXXXXXXXXXXXXXXXXXXXXXXXXXXXXXXXXXXXXXXXXXXXXXXXXXXXXXXXXXXXXXXXXXXXXXXXXXXXXXXXXXXXXXXXXXXXXXXXXXXXXXXXXXX-
