----E-ooTT-BX-B||XM-EB?XE---o---BB-MoBTBT-TX--B?-MX-X-ooB-o|-B|-E-o--M--?E-E-X?|-To-MTXT?-MM?B?o---XMEEMET-T-X-X-B-B?-o--M||-B?-B---M--M--XB?M?X?BEE-EX-BB-M-oXM-X||--oX-|?oX-T-X?M?--BXBE-BE--M-----B--
-X-EEX|B?-T---EB--BB-|BBE-B--oE--MB-M---B--?-Bo|-|M|-B----EMX-BX-XBE-----EX-X?--------?X-B-E-?oMM-|M----?o--BoXT--M-E-?-|-B--o-E-XM--BB|XB|MEBX--X?EoEBMX---M-X--T|XX-E-M-|X--X-X--?X-?--?E-oE-|---B-oo-
----?-?M?o--MM--XEoBBX?-Boo?-MM--XX-B|?M-B--EB-?|--BX-XBM?-XT-|XB-|M-X-EEX-BB?XB-MBT-XXMM----o-E-M--B-X-X---|o-XX-X--X-?-o-B--Bo---?--Xo-Bo-?X-T|-o-X|-BXMX??o-T?-?E-X-B--o|B-E-XB-o-EME|-B--B-BEXoE-??-
--B-EB--?MX-?--M--EB--?M-T--MM----E---XBoXE-M-BB-----B?--B--oXo?-X-M?-BXEMo--o-M?-Bo?---BB-?-TM-XoX-BEMXX-o--E--?-B-XX--oX-M---MX---B-E-BX-X-BMo-?M--?-o?E---X-MT-M-o|-X-B--?o|B---BX-Mo--B-B-|-M?TBT---
-EE-----M?oB--B---oE--?-|B-X-T?-XM---?ET?Xo-M--EE?-?M?M-X-?XEB?T----XoB-oMMX-M?o-B??---X--?MT--X-XX-XB---B?M?-?XX-MXBEETMB--oEMM--?-oE-o--Bo|--E--T--X?EoBoX--B??----TBE-?-oTBBM--o?EoBB-B?T|-T--|?E-?--
-??-|-|-BB-o--Xoo-BXoX---M-T-o----E--BTEo-oEB---T--BXBT-?BX?-X-??o--M---BX-o-MEXM|E--B--E--X|MB?-B-X-ETM--TM?-B|?B-|MBB?--------B-MT?XM-oo--MX-E--To----|-|-|-E?B--BBB----ooBB-XB-MoT-?-?E-X-M?-MX-T-oB-
-X-B--XEBXT---?o-B--XoE---?B-X--o--X---BB|-B-T--B|----?XEo-?-?M--??XBB----X-Bo-BBXB--Bo---?|X?B-?-B---oo-EE--MX-E-MXBM-X--EBBX-o-T-T--Mo-BXoB--?---XXoo|BX-TM---M|-M--|X--oB-BEEo|E-X-E--?-oBM?B-B?XX---
-MM--TXMTEB-M-BBXE-B---XM?-XT-?X|-B-B-??-oo--?--X-BX--MEB--XX-oX--|-To-?M-BX-oB-oX-B---X--XX----o-----B--BX?B|----?To-X-B-o-|-E-M-MEBMM-|XTB-XB-X?-T-oX-M--o|?-B--BB|--|TBo---o-E-oEo-MEE--?MXT||BB-?-Ev
--?-oo-TXMXXBT--X--B---EBo-M?---oX---M-?-E-EE-MXoBMT|--E-o--oM-?-?XBX-|T-B-XBoToME-------X-M|XoXMT-o--EB--?-B|??E-E---T?MoT-oM|oX-XBBoXM-?X--BBE|XTTEXM-XX|-oBB-TBo-X|B--?X-----|-BB----?-oM-EMB|?-?oBBf
--|---Bo-M----X-?|o?BoEEBBXE-X----o-X-X-o|MT--EBB-BT---E-BB-B-|?--o?o--o-oX-BMo---T--?-Xo---BX-XXE?XM-?--B-X---X----BT-oM-ooX-BXMX-?X-B-X-X---XB--o--BT-?|-X---Mo--?--T----B?MBXXo?X-X-B-B|-|T-X--oX--Xf
-T----MoMXBoX-MX-M|---B--oE----XM-?oE|--XB-MX?|-BXMBo?|BBo-B----BM--E---oXX-XBM-||-BMMMT-B-?-X-X--MB?-MM?B??M--Mo-METX-XooB??EXE-ME-MBXB-o-B-?--oTToBX-M-MB-MM|--B--o--XoTX-|-|-M?-X--o--?M-?o-XXTX-?-Bf
--X-oXoXMo-o?--o-X--X---XM|-XBM-E--BXB---M----oXM-?M-XM--BBMB--o-?EB-|?|o--o-oMXBoo-?---B-oX--|BB-B--X-?T|-EX-XoM-X--BB--T-X-X-oM?--B?T-?MX-EBoTXo-XB--|X-?X|BM-TXM-?-M?--oo-B----?oBX-?-B---oM-BB?X---f
-ME?o-?-EB-?-MEEEooB--XB?---XX-?---o-BBM-BMB--|BXE-?BEoMoEo--?BM----X|--o-M---o-M-ToXo----??--B-MB--E-XMB--o--M--?-------E??|-oBMX--XE-------X|T---XE---B?o--BT-XX--T-MBBB-|---MXMB-M|-oME----M--Bo?B--f
-BE---BBEE?-?-E-?-X--?X-----Mo--M|----??-X-E?oX---MT|-?MB----Mo-XX-?---|---?BXBo--M---oXX--X?o---??-BM?X-TX?ooE--?--XM--Bo--X-M--M-??ET-?X??-----X---?---?---------X-B-?-|--MBM?-EB|?o?M--B?X--oM-B----f
mXX?E-BB-ME-?---XB-?-M---X|B-|--oE-B-?-X-TBE-MXX-?To--oM-X-TBoX--XXX|o-E-XX-?---B|----B--X|T----|----oMTX-?-XM--o-T--XE?XEE----XoM-X--MX-Bo---M-E-X-----?-T--oX---BXoX-o-XBBE---?EB---?M-X?TB-X---TB--BX
XXXXXXXXXXXXXXXXXXX-X-XXX-XXXXXXXXXXXXXXXXXXXXXXXXX-XXXXXXXXXXXXXXXXXX--X-XXXXXXXXXXXX-XXXXXXXXXXXXXXXXXXX-XXXXXXXX-XX-XXXXXXXXXXXXXXXXX-X-XXXX-XX-XXXXXX-XXXXXXXXXXX-XXXX-XXXXXXXXXXXXX--XXXX-XXXXXXX-X
