----o---o----|-|E-X?o--X---MT----o--B-E----X--B-B-------T--TE-E-X|X---ET-------?--?-?|--|MEX|X?--o--o------B----M-X-------E-MoMB|-oB--ME--XT|-----E---XE|--?-----E---|?-----XT--MEM------BTM---E--X-----
--o-oE|-EE---E--B?-B-|M----BB?T-T---B----T-----T--BM-E-o-MX--EB-MM-|-----E--o---------T-|M-B------T--X-E--E-X-------?oTB----?-E------M---B----M-|TTE--??Xo|---T------------X?---?----T----o-M------|E--?
----BX---B--E--ET--|-----M--|---B---EB------o-MBEBB--B--B--|??T-T--X--T?----o--T--?-------?---------TM|--------E--M?-o---B-E-MBo|--?-X|----B---------o---?-|T-----o---XM?--XE-o---M-oX-E-----B--B?---M--
----oTE-----B-TX-T--M-TT--o-B--o|-o--------M------?-X-------ToE-T|-|E-o----M---o?----X--M--M???------B|T----------M--B------oX---E------T---o------o-MoE-o?Mo--Eo|T-----T-T---TM---M----o---M------E----
----B-----B----?--M---B------B?--TB---?o----Bo?-Xo-?-M------|ME?----o|--------B------X--E-M-T-o---o--EX-EX|-BBE------?--?----E|X--o----B--?oX?--o-----B-T--|---o-??-T?---------Xo|---TBX-------oB-?---M-
----X-EM-E---oM-----X--|-----B-M----oXo-TX---E--X---?--TM-o----o-----------B--------|B-o--|--EE---T------E-E-X-B-X-o-|E-M------B?---------T-o|M|---M----E-B--X-M--X-o-?-XTXEB----T-M-?-M-----M|X-?-T---?
---ooT-MMB----ME--T-oTB--o-|-B-T|-E--|-oM-----T--------?-MX?X-|---X--|B-------|o--X--|---M-oM--E??M?---oB?-o---TX----B---|----?T-|-----?------X--o---XBo---M--|-X--|---BBM------?-TX?o---X----|-----|---
---|----X-----?-o-?-X?-----BX-T-E------|-X-??-|M-BT-BT-------M---------X-----XE-----------E-X-T?----?---E--B------------oX--?XX-B-----TBEB----XB-----?oMoT-----?-B---o-----??------oo|-o-M-X-XT?-E--o---
-B----------?---?-?-?|-----X---M-|---MX--M|B---E---M----BX-?----T--M---B---E?-----B-MM-|T--X?-----MB-T-Eo------|T|-T----B-|----|oBX-----T?-E-?-oEB---|??------?M--X-o|B----?-M-?|--|------|o-E--?M?-----
-----T--M---o-ME--T|EB-o---XXo--TT-EM--?M-oo-o?-?--o-|---E---M--o----?--|---X---oM------?----E----XX----|-o-M--M-X---------B-|--?EoX?-M-o--X?X-------X---ETE?-?E--X----|-----|---|E--?-----XT-o---------
-----EM?B?-oE---B|-o|TT---T-|---MB--TTE----T----|T----MEo----o---E--XX--BE--|--o---E--E---o|-|--------B----oM-----TB----?--o-T--B---|--T-E---X--------E-E--o-X|-----T--o|o----B--X--|XX---TE--E?T-o-----
--||--M----T--T--------M|?---XX----ooM-|-M-E-----E-o|o-ETo-MX----oo--E---|M-B--|o---?--o-----T-o-|----o----B-o-To-?---|-o--MX?--XBBXEE--o|-o-------EBB-o-----?E|-----M-B----X-------M--|?--?-EX---XT-T-X
--M-M?MX-B-B-M-|-X-X-MT--o---X-------E---XoX-X-X|--|M|Eo--o?----?--------TE-|X---TXT----EB--|T---XM|-|-T-T-o--E-BoTM-?|-M-E-?------------X?----?-|------X|-T-o?--------BBX-------B|---X-------?-?--BBo--
-o-?------B-------o--MXEX--T-------TB-|-o?------X-M?Eo---X-E-M-----------B-M-Mo-|--o--MEoX--T----BT?|-T-----B----B-|-oB---?-|---M-X-B------?--XBo----------B-|--------|-X-?-?-M---T-?X---T---E-MBo---|T-
----?-?-M-?-oTB-B---X|TE-----------EB--X--|-E-E-----?-o-ME-TB---TMTM--BEM--o---------B-----?ME-----o---X-o--T----------E?oE-X----o-o----------T--X--X---E-----------|---B--|T-B-ooo-------T-TM?----EX-B?
-XXXXXXXXXXXXXXXXXXXXXXXXXXXXXXXXXXXXXXXXXXXXXXXXXXXXXXXXXXXXXXXXXXXXXXXXXXXXXXXXXXXXXXXXXXXXXXXXXXXXXXXXXXXXXXXXXXXXXXXXXXXXXXXXXXXXXXXXXXXXXXXXXXXXXXXXXXXXXXXXXXXXXXXXXXXXXXXXXXXXXXXXXXXXXXXXXXXXXX-
