-oE-------------X--o-E-?--EB-XX------E----o||-|--T-B-M--o|--T-|?-----------T--X--T-o-E-T-M--T-M---T---M--EM---E---M--------?-M---T|XB---T----o-|---X---Eo-T|-E-E-X-BME-----X-|-------X-E--E-T---oTB--X|-
-------E------|------|---o--o-B-----o--|------?-|-B---|oE--T------X?---Mo|--|o---E-X|X---|M--|---TE-X|--E--o-oE-M|-T---TB-B?-?-o-----?----oo-B|XB--|----M-E-|-B|----------|E---o--T---E-|T--|E------o-E-
----?-TB--X|-B--T------------B---T-o-E-----o---|------X--B-?-----------ME-----T-oB?E--|-TM--XBM|----X-EB-T---T---?E--?----?--|T----o|-o--M----------X?-M--T--B--?|E?M---|---|Eo---X--T-?M--X---??|o-Eo--
----X---X-----?-|--|-T--|------ooo---X---|?---T--oB---B--XT----??---T-----XM-E--M-----B------oE---o-B--|-EB-XMo-XM--?---B-----E|oX-?-----T------?-o-M---XT-XoX-XTX--B------|--XoM-X-BT-|-M-|-|---M--?|--
---?------------?o-T-XBEo--X-B-?-|X--To|T------B-E?--o--XMM--XEX-BM-T|M-----T----oB---E-B---E-----E--B-X-|---?------?o?-T--MX----|-X------T---X-----B--B---M--------XMoM----E-X----MB---M|--B------X----
-E|ET----o--ETT---E---?--|XX-----------B--XEM---o-E----BoM------------oo-------B-------o-B|--oo-----o-----X-----B-|?XX--o-------Bo----E--|-T--BM----|--E-T--E?-B--M-TMXM-------M----X-----?-oB---X-?----
-T-|B---------BTE-----|-|--E--|-|--|------X----T|-----|E|---M?-X-----E-----o---|T?----M---|X-M--o----E---?------|-T-M---ME|-?-------M---|-?--E---o---|---?-M|-M--o---EMo--T-B-T---|ET-|-----E------o--M-
-------B--BMo-X?T-X??-|-BB-M--E--M-o-B|X--X-?T|E-o-T---EoT-MToo---E---|---E---EB---------o--B--TB-X---B--E-E----|o-|--T|XE-o-ET-B-?---?-?-------TX-X----|-E-M-E------E---X----E-B-X-|X-X-?Bo-M----?--X-v
-------o--M--o-X-?----------o-|o--------|--|E---M--Xo--MM-M----oX---M--?-----M-o----?E-|---?--oB--M-BE-M----X?-------B-|M------B-----EE--M-----T------B--?----------M|M----X---|--B-X-oo-------------MTf
-|--?--MoM-?Mo---TTT?---------M-E|-XX--|-E|---o-oXX---E--E--o---E--?-BTE-?-?----o-----|X--X--B---M-TB------Eo-BEX?oXT-X-B---o?----T--------o------------E-|-M?--B------E--?B-?-XTB--oB-XTX-?-E-------MBf
-MBE--oB--?-T?E--E-----|E---B---X-E---T|EE--?---?EBT?-M---B--E-TBM----X-|---|-o-T-----E-oM-oo-----B-?B-----T----?-M|EE----o-|-----T-----B--------||-----|T-|M--T-M|---------o-|--oM|-o-BMX-oX-T--ET--E-f
----M-XoT----o-TM?B----BM-------E--|--?--M?--E---E---oMB-------X?---|T---E?-|-------E-MEE------B?-B----o----E------X-----T---T-|----M|-X-?B--------|-E-----o-MM---?-----MM?|--------?----------TX------f
--o--oX----T?-T-?-XE-----E-|M-|--?B-X-------M?----M--|o-XT--X--o-E|-o-----oB-E----|-----Mo--?--M?--XB-----|--E?-TE-E-?---?o?-----?---|T----B-T?-M--?----TB-M-------T-|---?B?-T----EX--|BoX---X|?---?To-f
----X---X-----T-?B--o-EoMEB---o--------------?-TX--X-----oB|-----oX-|-----T--B-|-----|---?------BTM-|---|o-----EB-E---|o-?--B-o-E-X|-M-X----o---B|B-oo-?-----MM--MBBoX|----T-|---X-----?o--|?----X--?-|f
m--BMT??----T----?-X--XM----T--T----T--MB?|-E|-?-|-----------B---MB-------------o-------o------MB--M----------M---M-M---|?-E-------T---|-Bo----o--TM------TBTE--M?---|-----M-----T-----?M-|--o-M---T-E-X
X----X---------------------------X-------------XXX---X-------------X----X---------X-----------X-----X--X--X----------------------------------------------X-------------XX-----X-X-X----X---X-----------X
