--ooX--TBB?--?T-o-?-ToE-E---EB-|?B--T|-TB|TMoX?-MTT-?---?BoTTX-T|TE-o?|T?TToBXMo?B-XX|-M-?ME--o?M-o-Mo-ooX-?-TB?oXM-?BX---X?-Bo-Eo-M-TT-oBoMXT-X-B-TMo---X---oTXT---MXoEo?T|oXX-To-X--?oXoX-o---B-E--T--
-|XToBM--|--?X--oTM|--M-T-oT-BT?TT-MT?oM---B-E-T--BoT---TE--TX?X-oTB|EEXTT-oTX|T--o-To?-?---?oTT-TETX-B-E|X|TXTo|T-T-TETXo??ToM-XTTT-XX-E?XX-M?T-X|-X-MTXTX-T-TTX?-X?TT-TX-BMBXEX-X?-XE-EXEXET|X-To-o?M-
-?-Xo-o-EE---X|-ooE|T-o--XXE-oTTBBTXo?---|TXX---TT?o|XBTTo-TX--ETo?X-?X|TXTBo?o|MTT-o-B-?XBT-MT|M?o|-T--ETTXX-EE??B-XXTM-ooX-oX?E?TXBM-?X-o-X-TTB?-XB----?--Xo-?MX-X?BTT-?oTo|-T---MB-|B-TXBo|-EXBMBXT--
---E|XM-?EET?T-TBTMM---T-o---B?-TX-ooo-T|XooT-?|X-T-MEM--?TX--|---?|--oB-To-BM?X-XX-oToT-?oMoT-B|-?|-B-|TMBX-MBT-BoT-|-?o-|ET?|?|XTo--o-T---TTo-E-B?-M-X--MXToM|-ToXE?ETMTo--X-MTX?-ooT-XoT-E-E--XM?--o-
-oTToMT??-M-o|-XTT-M-BMoB-B--TBoTET-?-MMXEBoBMXo-BET-X-M-X-o---oTTME-TT--TXBoEEM-X-EXT-?-TBX-?M--oo|o-XTBB--?ooTBoM|X-T--T?-B-?EM-oXo-B---Eo-T-B-BTT|-oB|?-E?-?X|B|TEXT---ET--T-T?TM-TB?-B-|?o?-TTT-XTE-
--oTXoXETBTTX-XB-o-ET-To?|--oo?-TXo--?XTo-XEMBEM----T?TB--|B----?-o|-EBEX--o-T?TT-B--X-B|oT--M?-o-oBMXXM?T-TT--XoEo-TE-BETMo--||Bo--TMB-EBoTXT?XXXoMMTX--oXTTB-T--M?oX-TTTMB?ToXoB-E-MTME-M-BBXBTTBXM-T-
--TX-?E-MB--M|BTTB-T---M|----XTXM--oM-EEX--oX-|XTX|---T--EXoT?-?T-o|o?--T-|-B?T-MXXTTTX--|Xo-?--BE--TEX-oB--X?X|T-|----oTo-X-T-?TXBBoBE-T-|-E-Tooo-ME-?--TTXX-TXM-?o---TB-----ToM-X|oB-X---ET-BTMT---oT-
-|-B--BT---EX|TB-EMEo--X?oTX-?--B?X---|o?o-??Eo-B--o---T--|TX|TMEEBXTTB-B?--T-?|XT---o-T---MTT-TE-BT-XT--B-ToTT--o?B-TT-?-XXoX-T-oToBMT-M---?-ETTMoT?BM----X-Mo|oTX-o-TXo-EoX---EB?X-M-o--??B---oET-X-|v
-?E-TT-TTEoo---XXB-TT--TMoXE?TTMT-Xo--MMX----MMTM-?X|BoMBTo-----oToM-TToXX|E--TB-XBo-ETEToB-TMEoo--o-Eo-TXo---o--T?M?ooTXT--?-oBTTToT-oXX--T-BTXoX-?T--oE-TX-oXBXTEX-BB-X|oET|BE-E--TBBXo-ToTE?Bo-X-|MTf
-MToX-TT-E-?o-T-|T|-T|--T--TM|MBBT-oTo--??T-ET|-M-TEBM-oo-B-ETEEEoB?-X|T|--TT?oBEBX--T-T--X?-B-B?T-o?B--E-T--To--T-o?TTo--MM-B-----XTX-o?oT-TB?-o---B?--TT--XTTM---?M-TT-MTBo|--oTB|BTX-o-ooT-XoX-----Xf
-----T??XooTX?oM-XoME-M?oE---?-TET--?oX--T?---T--X|--T-MB-T--E--o-oM-XX------TB-X?-X-?TXET?E-XX-TBX--T|o--BToBXMBT-|T-o|--To--T-Xo--T-Boo--TX--E-?|-T?----|B---MX-?-TX--o-----T?----ooX-oT--oXBB--TT-BMf
-M-?X--T--M-XE-T--ToTB-T-----BTT?T-XoT-T--XBBXT|--X-BB-TooX?X-M-o-T-X----oXTo-??MTo---o--T--E-MBXTE-XTMT-M-BTo-T-BXM--?MTEE--T-ToBEX---E?BX--T-BoXoMoB-M-T-o--To--ToTE-E--o?B-To-oEBT?-T|-oT-ooX-T?-XTBf
-T?Xo?-?o-o--?X-B?X-?EXo-?-o?--Xo--X-M-?-EoM-X-XoBB-TM--??BXXEX?-MM?X?-?-M?--To-?oB-BXB-?MBM?-BX?--B-|?MXEMMMEXX-?T-MB?--XXMB-E---X--?oBXM?o-oMTMM---EM?XB--oBBMBBM----?-XB-----B-oM-XoBo-?EBB--BoX---Xf
-EB-oBoX-BB-o--o-?oBXE----T?|Xo-?oXX-B-M?--oMBXEMX--XXTo||o|M-?--?BM-MB?-BBE?M-XB-X-|BoXBBB-E--|ooXBT-XB-XXB--X--B?XEo-?XB?-o?M--X-oM-XoBB-ToE-BXBMB?MBXBX-E?XXXBX-BM-EBX-o|-|-?BMX-EBoB-B-XBMM-E?|??Bof
mM-?Xo---XE-MB|X?-Bo-XB-?-?EXX?--?EM--Eo-?T?T-M-?T--XoBo-E?--XXMXTEB-?Bo--BEBo-o-?MM--X--Mo-oM-?X-oMBM-Mo?X-BBX?X-BMXX-M-XXooX?X?--oTXo?B-?oX?X-XoXB-o??-oXB--XBo?-XBEXoBE-oX-XTBX?BoB-??----?BMX--BE-MX
X-XXXXXXXXXX-XXXX-XXXXXXXX---XXXX-XXXXXX-XXXXXXX-XXXX-X-XXXXX-X-XXX-XXXXXXXXXXXXX-X-X-XXXXXX-X-XXXXXXXXXX--XX-X-XXXXX--X-XXXXXX-XXXX-XXXX-XXX-X-XXXXXXXXXXXXXX-X-XX--XXXXXXXXX-XXXXX-XXXXXXXXXXXXXXXXXXX
