-------------?--X--B----o-----M-o---o--------o--------------------E-?-------X-X---------------X--------?--M--------------------B?-------E-------------o-----------oE---M----X?-o----?---o------B-M--o---
--------B-o----o---------B-X--------B-----------X?-?----------B-MX----B--B------E------------------------------oM---------------?-------?-----------o-----?-----------o----E-----------X-oo-----o-------
-?--------------------o------X-------------o-o-X----?---o----------X--?---o----B?-------E---o-------------E---o--M-----------M---------------B--B---------------o--E-o------?X--X------------------XE---
-o---------------BX---------M--------E---M------X------?-E--o-----o-------B----o?--o----o-------o--E------B-----------BM---EE--B---o-------------E----o---X----------X-------?-----------------------M--
--------?---?----X----o?-------------M------E---------B?---------o---X--------o?X-X-----------o--E---------------o----------E------?---X--Eo-----E------B---------X---M--------M--B-----X?-o-------o----
---------oX-----o-------o--------X-X-B----E---Bo-------------------X----o-o-------M-M-------o-B-------oE-----XoB-X-------B--------B---o----------------oM---------o-----------o--X-E-------M------------
-?--------------------------?---o------------------------------XBo------B------?-------------------X------------o-----------o---------X-B------------------o---B----------E------?oo--M-----------------
--B-------------M----------E---B---E-----------X------------------------M----X---o----------BXo------o-----------------X-?--------o-X------X-------?-o--B--X--B-?-B-------Bo---o---o---?---------------v
----M-E---------M--o---------M------?-----------------XE------E-----E-------M--XE------------------?------?--------?X-----X-----?------o--o---------o---M-----------M-o---------------M--------------X-f
-----E------------------X--------X-X--------o---o------B-----o-------X-----M-----E------------------X-o--E-------M---B---------------B------------B------------oB--Eo---B-o-------------XB---oo-?-o----f
------?-B-o-E---X-----?-o--B-B-X-E--------o---------Eo-----------------o------E------------X----------B-o-------------------M------------E-----?---------B---------X----o----------oo----X-------------f
--?------X------------o------------------X----X?-B-----B-----------BX------o--------B------?--o--o-----M-?oX-E-----------?----------------o-----oXX-----------o----?---Xo----E-X-------------B-----o---f
-------B--T-oo---Xo--M-----T??o--o---------------T---T-oE-M----X--X-------ETM-Bo?-T-X---|T---T-o|X----X----E?-?BXo--E---TT-ET---X-E-T--o--E--XT--T----T-E--M---T--------|M-X?----T?----X?E---o--T--To--f
----------|--E--|--|TE-||-|-----|||--||B-|oT|--||o----|-||-E-||---X-|-||---T---X|--T|---T|---M---||T||----E|-----E||B--T---||T--|T?|-||----T--TE-EE|-T-M--X-||-T-|----|E|||--------|-|||E--||--|o----E-f
m----------B|||-T||--o--T?--|---|X--|-----|-|-|--|-|-|X-X-|--?-XT-|---?T|o--E-----EET-T--T-|X|-||-TTXTo-o?M|-----|-M-T-E--TT--||||-|E--|-E---o--|-||M|o---|T--|X|T--|-||||--X-MT|-E||M-|-TE----B-E---|-X
XXXXXXXXXXXXX---XXXXXXX--XXX-XXXXXXXX--XXXXXXXXXX-XXX-XXX-XXX-X--XXXXXXXXXXX--XXXXXXXXXXXXXX--XXXXXXXXXX-X-XXXXX-X--XXXXXXXXXXXXXXXXX-X-XXXXXX-XXXXXXX-XXXX-XXXXXXXXX-XXX-XX-XX--X-XXXXXXXXX-XXXXX-X---X
