-XoM--XXB-?oXo--oBX-XM-X-?-XX-XB---XE--XB---XoB-??-B-?--B-E--B-EXo--o?--B?T--X--E-----?????--o-TooooooBX-?--X-B---T?-XE-----E?--?-?--Mo|?---?---oMo-?-BB?o-?XEo-Bo-B-----X|o---oE-----Xo?M-o?-E?--XE-o--
--X-B-X?XEXBE?--?MXXE|---o-XX-------X-BB??--E---?--?--XMEX-X|-o--XBM-o--??-XX?-T-|-oo---E--|?M-X??Xo-o-Xo--o-o?XB?B-XXo---T--E--X--?-EMMo-B-Xo-|B-EX?-MM--oX-TBEBo----o-oo---B?XME-o-??-o---X--XEM-oM-X-
-XBX---?X-X?Xo?o?Mo----TXM-M?o-BE-M?-BXXX-?M-X-EB|--ooMT-X?o?E---XXB-M-X--To---?--Xo-?-oXXEoo--o----EXXT?-X-XX-?-BX----B-oooXo?XoE--?o-o?B--|-?|B-XBo-?X--XX-BX-MXoXo?-?-X-Xo-?ooMBXB?oMo-MX-oo---E---o-
-o-X?X--X-B?-o|?-----M-Mo--X?o---?BoX-?X----E--oX-EXT|?Bo-ooMTXoB-BXXo??|XEEoB--EoXX--M-E-?B|---M-X?XoXXB-BXMoooo--M?-EBEM-ToM-Xo-?|MX--B-?B-XMoE?|?B-?Xo--o?XX--?--E-?BX-?M-EXo---oXXEM-M-?E?BB-?BB?-E-
-B-|---?-B-o-M-oEX--?-E-M?E?X-E--?BB-M--oEoX-?B?EM?XTE?XXX?oE??X-o?MMX?--X--BT|Eo--M-----X-ME-B-XMo-oo?oX--X-----?-XX---E--X----oXXXM?--oTo-XB|-EB-?B-MX-oX?-??o-TT-E?XMo|oE-E----X-oBo--M---o-?o?M---X-
--?----MMXo-X-B?MMXo-E--M-??----oEX-oE|BT---B-E?MoXoBoXMoX?MX-XX?-X?---o---BEo?-X---BXoB?XBMoBEB---B--XEX-XT|ME?-MX-EB?------BX-M?-Xo---?-X---XE?-?X-?X--B?--o-oB---XXM-XooXMB?-o-X--XXM-B-oB--BoB-?o-E-
-?EoM-?|-X-oE-X--?B-?o--oX?-?-EX-XoX?EB----X?-E-oX---MBE|---X-ME-Xo-M?B-X-o-B--Moo-?-X---|E-B--BX--o?Eo--||oEEMoo-M-X--?-??XB?-o-oXXB?o?-XE-XoooXMB-|?TX-BX?MXTBB--?B?----?-Mo-BMEo-E-oE-E?--MXBBXX?--B-
--oX-?XXB--E---XE--oX?E|XB-XXM--B-?BB?MTXoXoT--oM-Mo---X-TBoXoX?-?-X-?-Bo?Eo|M-XB-?-X-X?XBM-o-??--TX-XMX-E-?-X?-----?o--o-M-X?o-XTXM-?X--?---B?--X?XX--X-XE--?X-----o-BM-|??---X--EXo-oM--ooX?E-o?Xo--Bv
-X-EoXo-X-EBoXMMM-TXE??XB?-oB--oXBE-EXE-XEE--?BE?-XB---E-?---oXX-Xoo---?-X-ME---X-?--XM?o?-MXo-XB|B--B-B--?-X---?-?-----BXXX-Mo?MXEBBB---o-----o--XX?-B?-B-X--o-oMEoXXXo?XX-oBXM-?X?-?-BE??Eooo-Bo-X-|-f
-EB?-XX-?--o?--XB-o-E-MMMEX?o-B?-??oX?---?--oE?XBX?M?|TXEXEB--?-?-Mo--o|--E---EXT--EEo?B?o?M?-XB??oXo-M-E?----XXoMXMXX-oB?-MM?X---oE--?-oX----?----o--?B-|Xo--?---E-Xo?oB|M--M?oX---o?oT---XXEX?-E?BoMMf
-oX-?-B-X-E-M-?E-B?-XBoTXo---E-oToE--?|-?XM---XoXX-X?E-BB-o-MB-B------?-B-X-??X--T?-MB-TBEoEoM--X-?XoX|?X---oM?M?X-oT?-TB-?-o-BoM-E---X---X-?-Eo??-M-B-oXXB-E--BBE?o?E--?--?-TM--XToE-X-oXo?-?-o-o--?-Mf
-X--BoX-B-E-||-ME--o--o--E--MX|BMMoXXX---XB--T---E-TT---o----MoE-X??-XEoT-E--o-BXE?o?-E-ET--BBTM?o??E?-EBX-oM?TXMEX-Mo---o-Xo-o-XX-EXB?E-B?X?-X--T-B?ooXoo-----o-??oB-E--?---BXoo---M?T-E--M-EX?M-oE-B?f
-X-?XMBXB-?MBo?oB-?BBE-Eo---TXoX--X-?M|----ToXoB----o-XBM-oooEMBT?X-BEo-?E--XX-BoMT?X---o?oTMXXMMXXooMBM?EB--X?BM-XX-?-X--XBo-B-B-oMMo-X-EX--?o-M-Booo---B-o-X?-XB-ToXB---|?BBT-MBBB-o-o-Mo?XMMX?M-BX?-f
----BooME--X--B--?--BB?X-BB-X-XXEo?o?-BoB-XB-EB-X-ooMMBo?MX-E-X-o?X?-?XM-oB---TE?oB-o-B-?-Bo-M-oXoo--E?MM--?o-oB-M-?EoB-T--oXEE??----oM-X-B----|o-M-BMo--oB?M|BBEo?oBXBBE?-oX---XXMTE-?XB?oBBo-oE?X?X--f
mX--MM??|-?BB?B?XEoM-M-o-X?XB--BooXX--EBB--|EMX---oX-MM----E?MBM-T--X--oo?-oEE-o-|M--BM----BT??TM?--M-BB-Xo-M-oB--?E---o-XEX-MoBB-BM--?-ME-XEX?------XBXXXBB-TX-M--BMX?BX-|BoEXEMMMoo-ooEB?-o-M?oX-BoX-X
X-XXXXXXXXXXXXXXXXXXX-X-XXXXXXXXXXXXXXXXXXXXXX-XXXXXXXXXX-XXXXXX-XX-XXX-XXXXXX-XXXXXXXXXXXXX-X-XXX-XXXXXXXXXXXX-XXXXXXXXXXXXXXX-XXXXXXXXXXXXXXXXXXXXX-XX-XXX--X-XXXX-XXXXXXXX---XXX-XXXXXXXX-XX-X-XX-X-X
