------------M---M------?-----X--------B--X----o-E--------?-------B---M--o------o----------B-----E-----o----------o----------------------X-?-o--------------?---------X------------o-B-------------------
-o-------B------------------------BB-------o---X-------------o-B----------------------X-X----X-X---M---?--B--o-----X--B---o-o--E-------------------------B-----X-----------o---o-----M-------B-B--------
--M----BX------B---------------X---------X------------?--X------------------?X--------------------------------o-Eo------------B-------E-----------------------?----B---?--------M-X--o-----------?--o-B-
-X----E--?----------o??----B--------E---o---M-E-------------X-------?---------B-?o---EX-------------M-----X-----o-?--------------E--XB-------o---?---B---E---X----EE---M-----------o-B------------------
-E----X------B---------------------------------o----------E-------------X--?--------X--------------------X--?------------XX----?-B-?-----o--?-X--X-------X-E----X----------XB--------------?--E---------
---------------------------M--X-----?---------M---------------X--M---o------------o----?-----------B-M------o-X-------o-----X--BX-------------------------o---------------?---------------X---o------?--
-MX-o--X---E--------------E----X--?------------------?o-----------B---------o--?--M--M---oM--X-o-?----------B-------M--o---------------X--?----------------E---X------E------M-------B---------------B--
-----------?----?----E----o-----------------X---------E------------------?-M?-----M-------M--------------X----------------o--------M-B-------M--B--X-----XX-------------B---------X-M----o-o-----------v
--------------------B---------------XM---E------B-------X------------o-------M---------------?-------X-X-------B--BX----------------B--------------------------------o--------?----o---B---------------f
------?------------o-o-------------o-B---X-----M-----------------o-----X---M-----------o---MX-?----------X--------------------------XM-o--?--B-BE---B-o-B----------------o---o----------M----X---------f
--------o---?---?-----------------Bo--------Bo-B--E--------o?-----X---------o-------------X--?--o-??----------B-X--M-o----------------X-------E-------B-E-------Mo-o---E-M-X------------M-------Bo?--M-f
---o--oX-----E--M--------E----M------X--------BB--?------X------------E------E-------MX------------------------------------E----o-----------X-o------M--------------??----------B--?----o--o-----o----Mf
-------X-----T--------------MXo--T---B-ooT|-X--TB----MTT---B------T--T----o?XB-o-------BX?--To-T-B-T--B-X--X-B-?-T|T--oX--TBo---B--?T-TTT---o--M-?|o-oXXX--B-|----o---o-B-o-EM-B---|--X--?------T---BXTf
-------X----|T?M-o---M--EoEoT|-B-X|--T--T--------M--ET--o-----M----XMM-----oB-?X--B--BE----T?TT--X-T--M-?|TTo--T--?T--------ME------o---T-M-------E--------ToT-|-TT-M---oB?-MB-M-?BB----TTE----Eo----X-f
m-----?-----o------To--T-B-?---E----o-X?---o?------BXXT----E-XE|T-?oX---|X--B---TT-----oX--X---B-MM-----T---|-o--T---BT--------------TE----------oM-o--X---E-?E-T-oX--?B-X--T---|TE-E-To-?TEE--T---T-T-X
X-XXXXXXXX-XXXXXXX-XXXX-XXXX-XXXXX-XXX--XXXX--XXXXXXXXXXX-XXXXX-XXXXXXXXXXXXXXX-X-XXXXXXXX-XX-XX-XXXX-XX-XXX-XX--X-X--XXXX--X--XXX-XXXXX-XXX-XXXXXX--XXXXXXXXXXXX--XXXXX-X-XXXXX-XXXXX-XXX-X--XXX---XX-X
