----B--X-----?---?----o----?----B------o--------------------X----B---?-----B-------------------B------?--o--??---------B-M----?---------M----------------X----B?---?-------|------B?----?--------X---B--
---------B---B------------?-?----?-E-??--M------B--T----------?--?o----B|---------------?-----E-------?X----o----------T----------|-------?----------|------B------B----------------M----------oo-T-T---
-E---B---------X---E-o-|M--------M----B-M------o---?oB----M?--E----T----M-XE--------|--B-----E---o-----o-E------E---------BTB-M|-?----------B---------------------M----------------?-E-oo--X-M------?---
-M----T-B---?------------MM------E--------EB-------E--o--E-------------B------?--o-|---------X-?-----------------------?|-----|------?--?----X--o--------Mo----------MB---?-------|--|----X-----TX------
-M-?-------------?o---?--------X-----------?X--------------B-o-----B-B-----B---------X---------o--|------T------B-E----?--------------------XB---------------E--B-X---?o-MBX--E---B----E------E----X----
-----XX----X------B---M-------X---|B-----B--?--B----------------?E-B-----------------E--o---X------------------------------|-B--B-X-----M------M-oX-|--BXB-?-X-------------------o---MX-----X---o--?----
-----X-X--T---?------X-----------o---o-B--------X----?--|------X------B--X--o?----M-B--------------------?E--E----o----?------o---o-o?M---------------o-----------B---?X---Bo----------o--B---o--M--E---
-B----------E-----EX-------------?-----B----o-M-X--?--?----?-----------------------X-X------|--------M---X---M--?BB-----BT-----------------|-----XX---B-----------------B--------E--B-B-----?-?E--|----v
--E---E------T-B----M-----B----------B--X-E-----B------o-oo--o--B-X?------|M-X--B--E-----------------------o----T---XX------------B--X---------ME-----X------|-------o---------------X-------------B---f
-------M--------T-----------X-------------Eo----B----M-----XE-M----|?--------X-X-X-T-?--------------oMB-------o-B-----o?-X--TT------X----X-----B--------------|------------B---E---?-o------X?-?-------f
--E-----B--o-M-EM------E--------B------------B-TB-?----Xo-o---B---------------X------o----oE--XM---B-----EB-o---B--M----o-------B--------E-----?-B-----o----E------M--------M--o?-----------------XX---f
-?X----BBM--?---------------------------B-----------E---------M----|--o---M-XX------XB-------E-o---------B-----M-M---E---------X-E?-M--B-----E|--------X-o------------E------E?---------T----?--?T-?---f
---?----E-----------E------o---T--B-------?-?B-------Xo--?-o------------X---------T-----X--------X------|---o-E----|-M--B-M--MX------T------M-------?-B-?-----M----E-TE------------X-----M------?--M-o-f
----BE----M-----B-M---------o-------------------?-M-|----oT----B-T----E-B----EB---XB-----------------------------X-------TX----B-E------o----X-M-----------------X---T-----T----------?-------Bo-------f
m----X---X-----XMoM-----------o-----------B----BB--E-----------------------------------------E--X---X--B-----M-T------------------o-------X--XB------------?M-B--oE---|o----|------------T---E------|--X
XXX--XXXXXXXXXXXXXXX-X-XX--XXX-XXXXXX-X--X-XXXXX-XXXX--XXXXXX-XXXXXXXXX-XXXX-XXXXXXXXXXXXX-XXXXXXXXXXXXXXXXXX-XXXX-X--XXX-XXXXXX-XXXXXXXXXXXXXX-XX-XXXX-XXXX--X-XXXXXXXX-XX-XXXXXX-XXXXX-XX-XXXXXXX--X-X
