--------BB-------E-T--X----?------------T---E-------?E--o------T--M-------------o---B-|-M----------E----T--------o------X-----------|-----X--T------|-----T---T-----EX----E-----?-?------------?--XE----
-------------------------------T-T----M--oo--?---BT--?--E--?-----o------M-----T------o----------?---X------oT---B--T-------X---E--?-?-----M---X-----------oM--------XB------------------------B---------
---T-T-----T--M---B------M-----T--------T---E----T--T----------------B---?-o-?--------X------T--------?--?------X--XX--T-|--------------B---M-------oo---X---------E-B-X--B-----o--X------T-T--T------o-
-------o----M--------?----T-------------oT--E--TEo----|---------X-------X---------T--|Eo------TT-------------X---T--B|B----Eo----?Bo--T--------?-----E------TT--E-T--?----M-?--o-?---o---B--E-----X-X---
-------E--------o---|oX-?-o--------------------B----?---B-X-------T------------------TE?MX---o-|-------X-------T--?-------?-----X------T-----------------|-------o-|----E-?-o-?-----?o-TT-|--X-----|--o-
-|-------------T--ET?----T-------------T--E--------------M--oo----------T--------|--------T----T-?--T-----------------BX-------|B-----T------BEX-----B-------X---X------X-o---o---------o-------X-----X-
-------T-X----T----------o-----T-o-o-------M---BM-o------?---------------|-o---E--------T---------T--B?-------------o-ET------E---------B--------TET-----------o----T-o----o-----X-T-E-T-T--oT----------
-T----|oM-------M-----E?--oo----T---o-------B--X------------X-----|-----T------oT-----?------------T----o----T-------X---|----X----E--------X---B----oB-------------M--o-----------?---T-----B-T--M----v
--T---M-?--T|-----X-|?--T-o?--o---X--?--o-oT--------------TE------T-X?---------T------|------M----?-----|---------|-T-o------T---o---------T-----XB---X----------------E--------------o-----------T----f
---T---ToT-T---T--oB-T-------T-------o-E-o----------------T-E---BM-------M--o-----------B?---o-----------T|-|-E------------TM--o-M---------o-------------|-------B--------M-MT-B----X----------T---?--Tf
-|-------T--?---?------------X-----X-------?------T-----B-----|-E---E--X------------M---T------T----T-----------?----E--o-X------E|ME-------E?-T-X-------------XT--B-T-B---T----o-----------------T----f
---------?-B---T------T-T---BX-T------B--------------o-----X---B-T------T---T------------X--o-E-------MT--------------?--X-------X-------------E----------T--T----B--------B--T------------------T---B-f
---To-XB---o--XBXB---|---o------o?--------T-?----T--BBoX-B----EE---X-----?T--T--?--o----T----ETT?T?---?TT-----X-T?-T-----|---o-o----Mo-E------|--?--TXo|-BEo-T--Xo--o-----ET-----XT---XX-E----X-T-MT-XBf
-T----|-----X---?------T-X-BXo-M-X---------B-BXXB-T--MMXo?--?--TXTB----|--T-o-?o?TXo-----ooTTTX-------------T---T---o?--o---MTTB--T--MBT---B-T-X-?|-|?---T-BXTo---o-T-----B-?------X-----X-B--T--ME----f
m-oMME---E-T-?X--o-E-----T-T--o-BT-T---BM---o---o-----o-T-----|B--T-----B-MT-T---EXo---------MB||-TX-?E--X|TB--M-?XT?M--M-----To---T---E--TB-----MXX-----TTE--E---|--?-----|-BB------T-ETM-EX--B-----T-X
X-XXXXXXXXXXXX-XXXXXX-XXXXXX-XXXXXXX-XXXXXXX-XX-XX-XXXXXXXXXX---XXX-XXXXXXX-XXXX-XXXXXXXXXXXXX-X-XXXXX-XX-X-X--XX--XXX-XXXXXXXXX-XXX-X-XXXXXXXXXXXXXX-XXXXXXXXXXXXXXXXXXXXX--XXXXXXXXXX--X-XXXXX-XXX---X
