--To------o--------B---o-----X----?--oT-X----------B-M--|MB---------M----T-B---B-B--X------B?----o------E----?---ET-T--?---------------|T----|-MX----o-----B-------------|----B---B-|---|-----?--|--B---
-----?B-B?-----B-?-------?EB------?--X-X-----B------------B---o----MX------|---X---?------------E---E-----|---M-EX--o--T----E-----------E-E?--Bo--E--X--o--------?|?---|M-----X--X----M-E-------M-|-----
-MXM-T-----?---XE-|----X------?------o---|--B---|---oT|B|----?-MM--?-B-T--B|-B--E---EXB----o-T---B--TE---------E?-BX---------?----X-o-X-------------E-------?---E-?----------------------?-?----?-------
-------o-M---XE--M-B--|------|----T---M-?---E-----E-B?--X-|---E|-------T?-oM--T---X-E--XX-----M-X--o---E---|-X---M-------BT---M--|--|XXM------------------T------M-----------?B--|----T-oB-?B|E-B----M--
-?-?---o-?---o--o--T----T-|---X-----o-B-?-X-E---------B---M---?-o-------------oM?----o------M-E|-XEM-X----|------|-?-?-E|---?o-----M------X-T-?-X---T----?--T-----B-----T--E-o--T------M------------X---
-X-----Bo---B----B---E-------X-E--M-MEBB-----T|--------------?------o-T-T---|---?X-?T|-----M---|-B-----------BE-o?-M-T--T-X-?E-XB--|--M------E----------X---TX--?--o---o-B-------M-B-M-----MT-M---------
---|---X--E------T------------|---------B-E---?-|--o-----MT--X-?---?-o------B----B----X---oB--B--o--XMT-----E----?--X---?o----------T-?------B--M-|-E-E---T-E----EE--M--------------------o-------o|--M-
---X--B-T-|--|-------E--B---X-?-M---|----------|-----|----T-T---M-?B---X-B--------|T--|B-B-------M--|E-B--------|?--E---|-----X---------B---|---oo--|--|---------------|B-o-TT-?TME-E?------TME----M---v
-B-------B--o-T--X------|X|-T?--X--E--?||T-M------X--B|-M-T------|--------|X--B-T-TE--------T-M-T---X----T---B----T--M-|-?-X--B?BB----M--|-X--||----?B-----XT-----E-o-T-X---|?------B----T--------oT-B-f
-M----o--X--E--oo-o?|---X-E-TX------|M-------E-----E-|---------B-T--E----o-------------|E---MX-----------------M----M---|------|---T----X-o-T-|X-B---|-----??-----XB-X----|-EE-|-B-B-------MB--MT-----of
--M-T-|MB-|----T---o-?--------X-T-?--o--------E------X-----T-----X-M-E-------?--E-B--o-XT--EBoXo-|o----X-o--M-X--T-------E-T?---X|--T-----BE-o-E-Mo-------Bo--B---E-------XX|-XX---?X--E?-?-------?----f
------oE-o-------X--B--------M------B--T--?X--|o---T----oo--T-----EB--------------T---|B--o----||------T-M-o----E---T------|---E-------T---ET-XE-o----X-----XoB-----E-----E---BB-TE-------|---------X-|f
-X-------E-?o-|---E--|-BM------X--X-----o-E-M---------B--X---------B--|-------MX--o-----T--MX----E--B------o-E-----T--B-X|-E-X--X--B-----E----------M--XB---?|-----|--X------B-|T-B-----------------o--f
--BM---------T-M---------XT---|XB--ME--?-B------?---E|-?------|T------o--B-----X---M------o-------------E---?----X------E-E----o-ToX-XX---B---T--M-------E--|------------------------BB|M-----?---B---?f
mE----M---E|--|TX-o------oB|-----o-----TB-M---------Mo---o---X|-EE-o----------|-T----T-|-E---X------ETMM----?E--T---E--|---|--?-||------oB-----X-X-T------T----------|--o----T-B-B----?T--T-------o---?X
XXXXXXXXXXXXXXXXXXXXXXX--X-XXXXXXXX-XXXXXXXXXXXX-XXXXXXXXXXXXX--XXXXX-XXX-XXXXXXXXXX-XX-XXXXXXXXXXXXXXXXX-XXXXXXXXX-XXXX-XXXXX-XXXX-XXXX-X-XXXXXXXXXXXXXXXXXXXXXXXXXXXXXXXXXXXXXXXXXXXXXXXXXXXXXXXXX-XXX
