--------------------------------------------------------------------------------------------------------------------------------------------------------------------------------------------------------
----------------o----------------------------------------------------------------------------XXXXXXo----------------------------------------------------------------------------------------------------
-----------------------------------------------------------------------------------------------------B---------------------------------------XXX--------------------------------------------------------
------------------------------------------------------------------------------------------------------------------------o----------------------------BBBBBBBB-------------------------------------------
------------------------------X---------------------------????????---------------------------------------------------------------------------------------------------------------------------------o----
-----------------------------XX---------------------------------------------------B-------B-------------------------------------------------------------------------------------------------------------
----------------------------XXX-----------------------------------------------------------------------M-----------B-------------------------------------------??------------------X---------------------
---------------------------XXXX-----------------------------------------------------------------X------------------------------------------------------------------------------------------------------v
--------------------------XXXXX----------------------------------------------------------------XX-------------o--------X-------------------------------------------------------------------------------f
-------------------------XXXXXX---------------X-----------------------------------------------XXX------------------------------------------------o-------------------?---------------------------------f
------------------------XXXXXXX-----------------------------X--------------------------------XXXX------------------------------------------------------------------------------------------------------f
-----------------------XXXXXXXX----------------------------XX-------------------------------XXXXX---------------------------------M--------------------------?--------------------o--------------------f
----------------------XXXXXXXXX---------------------------XXX------------------------------XXXXXX---------------------X----T---------------------------------------------------------------------------f
---------------------XXXXXXXXXX--------------------------XXXX-----------------------------XXXXXXX--------------------XXo---|--o------------------------------------B--------T-----T--------------------f
m-------------------XXXXXXXXXXX-----------------------E-XXXXX----------------------------XXXXXXXX------------------EXXX----|------------E-----------EE---------------------E|-----|--------------------X
XXXXXXXXXXXXXXXXXXXXXXXXXXXXXXXXXXXXXXXXXXXXXXXXXXXXXXXXXXXXXXXXXXXXXXXXXXXXXXXXXXXXXXXXXXXXXXXXX--XXXXXXXXXX----XXXXXXXXXX|XXXXXXXXoXXXXXXXX---XXXXXXXXXXXXXXXXX-XXXXXXXXMX|XXXXX|XXXXXXXXXXXXXXXXXXXXX
