--X-|-----X|-?MM---?----E--E--o--ET---XoB----T?MM---oBE?------E----oB--BB---o-------------o--EB-----TX-E---E-X-----EX-o--?---B-Bo---?-T-----Eo-|?--T|--o-----T----?------o--o--X------BT---M---EM------M
-?-X---T-X-X----------|-X-M---TM--o-?---MX|----?|---X-?X-M-|-Eo-X----M--B--------T----?|X---X-----B-----??--Xo-----?--------BE-------M-----B|----B-----T-B||T?--o------Mo--B-MM--|----EX--M-----XX--X-o-
--|-|X--|-X-T--T?|E-----M-|?------TE----T------|E|--MM--T---?----X-|-o-------X-M|o----?E-BoMo------M--E-|-T-------B-------T|---o--TEXX-Bo-MT----?---E--o-----M--o--XE----B-X-?-E---MoET-X------B|--BXX-X
----?|----?o-----?M--E-----T--o|-E---T---BE--EE----------Mo-T-o-Eo-E-?E-|-|-E-o----?o---XM-M--E--?-T-X----------M-|--M--XB---B-|-MTME-o--MBB--|-ET--?----E?-TM--||-XM-oM-E----?X-?-E--B--o---T--?-M--E?-
-----T-----EEXoT----T--T---?-EEXXM-?--oX-B--B--Eo---MB-----B-------E--ETTMX--X--o--E----o----|BB-o----|B-B-----oXo------o--MB----XE----|M-oT--E----B|oB-o--B-----|-To|T-------M-T------?-T?----o--EB--|-
--?-|--E-?-BB-----E|o---T-|---M--B---?M----------E---Bo--MX-?-?------?--|E----|-Mo-?---?--B|TX--X--E---o-?--X----XB-|-BMX---ME-|-o-----BT----M--E-------MXM--X??-X-|--|-X-T-T-----T?-Eo-X----B----------
-----TME--ME---MEM-E-B--T--E-B?E-----?B----------ET|--X-M--TM----|---|BX-EX---EBXT-------|----B-TX----X--M?--------E------ET-BE--E--X?M----|-X---EM--o-X-----?--?B--?|-T--M-|---MoX-------E---o-o-MT?E-X
---B-?XE-------------oB----B-BXT--|--E---Xo??-B--|o-T?oXT-----ME----|--X-|-|-B-----TT---?MB-M-------?-M--T--|----Mo--M---BE-E-M--|T-|--B||----M-M-T--?----o-----T--|-|--B----o----Mo--?-XT--|--|M----E-o
--|-----TX--|X--?----o-E-B--|--E|---E---|-|---o-B---E-------E-EE------M----EM--E-XB---------X-E---------------T-?-M-M-o|--T-o--BToEEB-M-Mo-o?-T-|oX?---o-M-X-?-MX---|--B-B---o?o-?---??-?-Bo---------M-o
-E--XB-E----M-?----MT-------TT---B---?B-|-----|--XTX------B--B|--?oB-E-BT---o----X-----|-B--M-----M---EB-M--B---ET|---|X----X------T--|-------EM--M-|T--X------M--M--o--B-------B--------o-M---|--B-MT--
-|M|--?---X--|--||?X-o------oXoM---TX-|-----o-?-M-E-------EoB----|--o-----?-------|TBB---?-B--E---M|-?-TB--------B-----M-|----XX--o---T--T-E-?|--o-------XE--o?----?----------M---M--|---|M---B---M--?-E
-EM----|-B-BX-----M-?--T--|BMT----M--M-|EM---T--M----B----?TM?E-----Eo-B--?-X--BM----M--o---------oo-B--X|--E----E----E--?-|EX--?--o-----X?--?-o-B-M--?-------X-o---XT-?--BX|B------??-BTB-E--?-?-BB-M--
----TEo----?T--o---ET-X-oE--MBE---------|--|M-TEE--T-?o--?--oT-??---M-EoE--T--B--|oB?X------??---B--T-M-|------o--?-T---M?--------T-?--M-T-B---T|X-T---MT|X|--X-------M--M-----To-|-?ETE---?-X----T-|---
-XE?T-|-----T-X-o-M-------B-X-M--MXE-E---BMT?M----?-|----BM--o--------BE-----M--TT----TX---Mo--X-----------?o----E-|MB-X------XX----E-o---X?-E-oBoE-MoM--E-?|-----T-MET----?-----oB----------TM-M-------
----X?-M-|-o---T-B-o--o-o||-o-E--|------TMT--B----?--T-MX-X-M-ETE-T--?-BMX----E-----?BE-E--M------T--E--|?|--|-|-----?-M-------TX-?E--|-----?-?--oM--|----E--X|----M-B-|-----T-----X-E-----X-X|BE?---M--
-XXXXXXXXXXXXXXXXXXXXXXXXXXXXXXXXXXXXXXXXXXXXXXXXXXXXXXXXXXXXXXXXXXXXXXXXXXXXXXXXXXXXXXXXXXXXXXXXXXXXXXXXXXXXXXXXXXXXXXXXXXXXXXXXXXXXXXXXXXXXXXXXXXXXXXXXXXXXXXXXXXXXXXXXXXXXXXXXXXXXXXXXXXXXXXXXXXXXXX-
