---X--------X------X--o---B--------------o-?---------------------?--M------o-BM---------X----------M-------M-----B------o-M--------------oM----X----------------oo-MB--Xo--M---B---?--?------o--------?-
-----X-----o----E-------o-----E-----------oX---o--?---oo--------XM---o-o---X-?E--------------X---------------------------E--ooE--X----------o---o-------------X--?-------E----Xo---B------B---------?---
-------o-------E------------------B---B-------------------o----------M------------------------------M-------------------o-------------o-o-o---------o--------------E--X-----------------------o---o-o---
-oo-----M------o---------o-------X----o-------------------X?-?---oE-B-----BB---X------?o-------M-----------------------o--?--------M-----X-----o-M---------?-------B----------E--o-M---E--X----B---X----
----o-Xo-?-X-----------BX?-----oo----X----------o------------------E--M--B--------Eo------------o-------M---o-----------o----------------------E------B-?--E-----------B-----?X-B-------------------?o--
---M---o----X---Xo-------M-o-----o--X-----M----M----E-?----o-E--E-X-o?-------------------------?---------------------------E---------------?-----X-M-M------------------?----------E--------X--o---?o---
---?X?-X---X?---------?----------X---X-----o-o-------------X----M-----?-M---X----X------------o-o-------?-----------------------XX-X-----------------o----X------XX---?------------B----------X---------
--M---X---X-----X---B---X-X-----------E---o----o-?-------B----------E---------B--X--X------------?--Bo-------oX-----B--o------M--o-------------B----o--BX-----X--------M-?-?X--------------------------v
--o-------------------------M--------?-----B------------M--X---?--B-----E------o--------------EM--------E-X---------------o-----B-----------?----------o-X--------B----------------X--o----o-oE--------f
--------?----------o-----------------------?---------?-M----------------o---E--o--?X-----M-------X--------B----?X-------M-o-----B----BE----B-M--M--oo------o--B-----------M---o------------X------E----f
-----o---E---?--------------------?---------?--o-?-----B----------------------------------------o---------B------------X--------o----------BB--?E--X--o---------o-----B-----o-----?-------E----------?-f
------------E-----?------BX----------------E--X------------M----?-E---------------------B-----M-----------E-X---------------o------oE---E-------BX--B--o--X---------------XXo---------E----------------f
--------X----B--B-o--------X--------XB-o--o?-?-B?--o-------?E-----MB?M-M-----EB-X-o---oXB---------X----X----------o?-o-M-?-----XB-EX--X---X----------X------B--?-------?----BB--XE----M--?B-M-X---?----f
-------M---B-----XE---E--T?-EE---EE--X----X-TX---TB-E---T-o---------XTT-----TT-E?---BE----o----E---B--------X--------E-E---E--E------o-------X--?---oT--?B-B?--X------------T----E--ET--EB---X-E--o-E--f
m-----------BE-X---------|--|----T------TT--|?|----B----|-------T-E--|-T-T--||--T-Mo----oT---B---ooo------T-X----T----------------oE--------X--------|---M----|-------------E----|--E|---B-T---E-E---?-X
XXX-XX-XXXX-X-XX-XXX-XXX-XXX-XXXXXXX-X-XXXX--XXXX-X--X-X-XXXXXXXXXXXXX--XXXXXX-XXXXX-XXXXXXXXXXXXXXXXXXX-XXX-XXX-XXXX-XXXXXXX-XX-XXX-XXXX--XXX--X-X--XXXXX---XXXX-XXXXX-XX-XXXXXXXXXX-XXXXXXXXX-XX-X-XXX
